@04Choolo	@oaxs
@1000noticiaspy	@oaxg
@112cyl	@oaxf
@11Dexspin00	@oaxh
@11Krnos96	@oaxk
@123456clamide	@oaxw
@14091968	@oaxu
@14lLaita91	@oaxe
@17bdb4d9ee92445	@oaxc
@18loboguerra	@oaxv
@1961Tokio	@oaxd
@1davidlazaro	@oaxr
@2022_alvaro	@oaxl
@2030trash	@oaxt
@20m	@oaxj
@24clm	@oaxz
@2Viejis39	@oaxp
@2ulisesz	@oaxq
@52municipios	@oaxi
@67quijote	@oaxb
@77populacho	@oaxn
@7thais71	@oaxy
@7uanF	@oaxm
@85Estebancer	@oasx
@9Balas9	@oasg
@9ddbf709696f4f6	@oasf
@A03627914	@oash
@A3Noticias	@oask
@AABenedetti	@oasw
@AAguerrero2009	@oasu
@AAretxaba	@oase
@ABARuleofLaw	@oasc
@ABC_CastyLeon	@oasv
@ABC_Madrid	@oasd
@ABCaustralia	@oasr
@ABCespana	@oasl
@ACNUREcuador	@oast
@ACNURPeru	@oasj
@ACNURamericas	@oasz
@ACNURspain	@oasp
@ADSABLAND	@oasq
@AE1987AA	@oasi
@AECID_es	@oasb
@AFCAjax	@oasn
@AGANA58627798	@oasy
@AGE_AL4	@oasm
@ALACIP_oficial	@oagx
@ALEJO_UR	@oags
@ALTUNILLAS	@oagf
@ALnaviocom	@oagh
@AMT_Quito	@oagk
@AMdHL	@oagw
@ANGELOFRANCOS	@oagu
@ANII15083615	@oage
@ANIMA_red	@oagc
@ASolucel	@oagv
@ATopeFeliz	@oagd
@AVAuniverse111	@oagr
@Abogacia_es	@oagl
@AbrahamJ7B	@oagt
@Abyzeth	@oagj
@AcEcologica	@oagz
@AcantiladosP	@oagp
@Accem_ong	@oagq
@Acnur	@oagi
@AcnurColombia	@oagb
@AcnurMexico	@oagn
@Acobag	@oagy
@AcodresNdeS	@oagm
@Acuame1	@oafx
@Acv2alexis	@oafs
@AdaColau	@oafg
@AdanEsmit	@oafh
@Aditusonline	@oafk
@AdriRM33	@oafw
@Adri_Billo	@oafu
@AdrianBarbon	@oafe
@AdrianDiazMarro	@oafc
@AdrianaLucia	@oafv
@AfrofemKoop	@oafd
@AgedaAR	@oafr
@Agencia_VN	@oafl
@Agenda2030_	@oaft
@AgusSubZero88	@oafj
@AhmedFa60832006	@oafz
@AidaGascon	@oafp
@Ainsthrilln	@oafq
@AiramHernandez9	@oafi
@Aitortxv	@oafb
@Akram9310111665	@oafn
@AlBorde_del	@oafy
@Alabaster_girl	@oafm
@AlarkonMaurizio	@oahx
@AlbaRosado_	@oahs
@AlbertoBernalLe	@oahg
@AlbertoBfan	@oahf
@AlbertoCasado8	@oahk
@AlbertoJuliaan	@oahw
@AlbertoLoredoP	@oahu
@AlbertoNeiraL	@oahe
@Alberto_charro	@oahc
@Alberto_rcde	@oahv
@Alca_Martires	@oahd
@AlcaldiaCucuta	@oahr
@AlcaldiaDeCali	@oahl
@AlcaldiadeBosa	@oaht
@AlcazarDeVbeda	@oahj
@AldeaFundacion	@oahz
@AldrianCG	@oahp
@AleDuranGR	@oahq
@AleJacintoUrang	@oahi
@Alejand28935481	@oahb
@AlejoMunante	@oahn
@AlephEdu	@oahy
@AlertaNews24	@oahm
@AlertaZeta	@oakx
@AlexLopezMaya	@oaks
@AlexTienda	@oakg
@Alex_s_stooges	@oakf
@AlexaAc3333	@oakh
@AlexaGomezDos	@oakw
@Alexandra_Arce	@oaku
@Alexis47472076	@oake
@AlexisR19919425	@oakc
@Alexmag93	@oakv
@AlfAguera	@oakd
@AlfieSolomom	@oakr
@AlfredoOrtegaEc	@oakl
@AliArnau	@oakt
@AlicciaDs	@oakj
@AliciaMelchorHe	@oakz
@AliciaTsMn2	@oakp
@AliciaVallina	@oakq
@Alienhohner	@oaki
@AlirioUribeMuoz	@oakb
@AlmeidaPP_	@oakn
@Alpanpan11	@oaky
@AlvaroLeyva	@oakm
@AlvaroUribeVel	@oawx
@AlverniaAbraham	@oaws
@Alwayszurigorri	@oawg
@Amadorjp_	@oawf
@AmaliaRoldnRuiz	@oawh
@AmanteDelFtbol7	@oawk
@AminMaalouf	@oawu
@AnaBolena33	@oawe
@AnaJimenezTV	@oawc
@AnaLuABC	@oawv
@AnaPaolaAgudelo	@oawd
@AnaTorres1901	@oawr
@Ana_R0101	@oawl
@Anaasgc	@oawt
@Anacanao1	@oawj
@AndaluciaJunta	@oawz
@Andaluz8118	@oawp
@AndaluzKapitan	@oawq
@AnderssonBoscan	@oawi
@AndreaPavon4	@oawb
@AndreaSegura12	@oawn
@Andreaguzpa	@oawy
@Andree_NavarroS	@oawm
@AndresFornells	@oaux
@AndresPinzn19	@oaus
@Andres_GuevaraC	@oaug
@Andy_LMJM	@oauf
@Angel57649704	@oauh
@Angel9deJunio	@oauk
@AngelCruzJ	@oauw
@AngelJimenezA	@oaue
@AngeldTorresA	@oauc
@AngeloPT4	@oauv
@Angieharumi	@oaud
@Ani_veg	@oaur
@AnibalGarzon	@oaul
@AnitaMGalarzaA	@oaut
@Annderzzz	@oauj
@AnnieLeonTomSt_	@oauz
@Anshi_hm	@oaup
@Ant52529536Jose	@oauq
@AnthonyLaser8	@oaui
@Antifaxismoa	@oaub
@Antonio66AG	@oaun
@AntonioCunha79	@oauy
@AntonioMaestre	@oaum
@AntonioMautor	@oaex
@AntonioNedel	@oaes
@AntonioRNaranjo	@oaeg
@Antonio_r__g	@oaef
@Aortizlemos	@oaeh
@Araceli11936531	@oaek
@Araski	@oaew
@Araujismoo	@oaeu
@ArcadeRider	@oaec
@Area2RRMM	@oaev
@Argarion	@oaed
@ArielRotOficial	@oaer
@Aristera1917	@oael
@ArmadaColombia	@oaet
@ArmandoMendozMx	@oaej
@Armunho	@oaez
@Arocajon	@oaep
@ArqueologiaJ	@oaeq
@Arquitectico	@oaei
@Arrested_Word	@oaeb
@ArrobaFulanito	@oaen
@ArteMapacheArt	@oaey
@Artepolis_es	@oaem
@ArtesacroT	@oacx
@AsambleaEcuador	@oacs
@AsbelBohigues	@oacg
@AsoDeporCali	@oacf
@AsobaresNS	@oach
@AteoAnalitico	@oack
@Athenea09126	@oacw
@Aucas45	@oacu
@Avivir	@oace
@AytMolinaSegura	@oacv
@AyuntamientoVLL	@oacd
@Azucena51132427	@oacr
@Azucena67015389	@oacl
@BBVAInnovation	@oact
@BIG_CH0L0	@oacj
@BRANDT_Europe	@oacz
@BTSVSpain	@oacp
@Baba43696141	@oacq
@BalbontinCas	@oaci
@BancadaPkEc	@oacb
@BancadaUNES	@oacn
@BancadaUNESec	@oacy
@BarbudoColorao	@oacm
@Barrocopardo2	@oavx
@BaseCBGC	@oavs
@BastidasLS	@oavg
@BazoJawed	@oavf
@BeatrizTalegon	@oavh
@Beeebrief	@oavk
@BeluLombardi__	@oavw
@Benjamn3108	@oavu
@Benzema	@oave
@BerbelJbn	@oavc
@Berserk24490143	@oavd
@BesttaYT	@oavr
@Betyks	@oavl
@BibliotecaNalCo	@oavt
@BilheteriaCAM	@oavj
@BisCharles373	@oavz
@Bitcoinanarka	@oavp
@BladeRG7	@oavq
@BluRadioCo	@oavi
@BlueLip97115642	@oavb
@Bmesacope	@oavn
@Bobores	@oavy
@Bogota	@oavm
@Bogota2022	@oadx
@BogotaEE	@oads
@BogotaTransito	@oadg
@BolanosAlamo	@oadf
@Borges_es	@oadh
@Borrokaz	@oadk
@Borymar	@oadw
@BrainstormCarlo	@oadu
@BraisCalvo1	@oade
@Brasuzzz7	@oadc
@Brayam9600	@oadv
@BrendaCV70	@oadr
@Brissa12395886	@oadl
@BrnoMerlos	@oadt
@Brucke9	@oadj
@BruniBucci	@oadz
@Bruno_Gomez24	@oadp
@BryTiago	@oadq
@Btaorly	@oadi
@BtcAndres	@oadb
@Burns055	@oadn
@ByRobertMurray	@oady
@CADENA100	@oadm
@CAMBI0SD3LUNA	@oarx
@CAMBIOSCASTILLO	@oars
@CASAfrica	@oarg
@CB1939Canarias	@oarf
@CCDMunicipal	@oarh
@CCVRT	@oark
@CCanaria22	@oarw
@CCivicaCatalana	@oaru
@CDHGYE	@oare
@CDPromete	@oarc
@CEARefugio	@oarv
@CELTICO1962	@oard
@CERI_URosario	@oarl
@CHINOMIXDJ	@oart
@CICR_co	@oarj
@CIDH	@oarz
@CIncluyentes	@oarp
@CJudicaturaEc	@oarq
@CLDETF	@oari
@CLOC_LVC	@oarb
@CMHNTM	@oarn
@CMonaita	@oary
@CMonteroOficial	@oarm
@CNCOmusic	@oalx
@CNNChile	@oals
@CNNEE	@oalg
@CN_Banyoles	@oalf
@COE_es	@oalh
@COJM2022	@oalk
@COMANDANTE_EJC	@oalw
@CONAIE_Ecuador	@oalu
@CSEmelec	@oale
@CSIC	@oalc
@CVONGD	@oalv
@CabraTira	@oald
@Caceres_Basket	@oalr
@Cadiz_CF	@oalt
@Cadiz_es	@oalj
@Caidadelatorre	@oalz
@CalentitoSound	@oalp
@CalimeroInfante	@oalq
@Caliu_A	@oali
@CamaraGCanaria	@oalb
@Camavinga	@oaln
@CamavingaSmiles	@oaly
@CaminhasLauro3	@oalm
@CanalesFDS	@oatx
@CancilleriaCol	@oats
@CancilleriaEc	@oatg
@CancilleriaVE	@oatf
@CantareroNieves	@oath
@CapitanBitcoin	@oatk
@Capitana_espana	@oatw
@CappieESP	@oatu
@CapsulasFutbol	@oate
@CaptainMiller	@oatc
@Caquintero13	@oatv
@CaraBM6T0W	@oatd
@CaracolRadio	@oatr
@Carlaa_1993	@oatl
@Carles83299878	@oatj
@CarlesSantacruz	@oatz
@CarlirousParte2	@oatp
@CarlosArandaCs	@oatq
@CarlosCarrilloA	@oati
@CarlosLazcano97	@oatb
@CarlosVerareal	@oatn
@CarlosXimielga	@oaty
@Carlos_Luna_R	@oatm
@Carlosiden2225	@oajx
@Carmatpor	@oajs
@CarmeN_0470	@oajg
@CarmenMa092	@oajf
@CarnetDLaPatria	@oajh
@CarolinaCorcho	@oajk
@CarolinaMora79	@oajw
@CarpinteroAlejo	@oaju
@CarrefourES	@oaje
@CarrilloRosero	@oajc
@CasaReal	@oajv
@Casaafrica	@oajd
@Casaarabe	@oajr
@CasabanRoberto	@oajl
@CasadoLuisma	@oajt
@Cassandracass50	@oajz
@Castell√≥n	@oajp
@CastillaSenador	@oajq
@Castillo__Rm	@oaji
@CatalinaSuarezB	@oajb
@CatalinoMeltro2	@oajn
@CatalunyaAC	@oajy
@CatanyolClub333	@oajm
@Catiuskasole	@oazx
@Cavalli_Daniel	@oazs
@CayzerDon16	@oazg
@CcagigalNeira	@oazf
@CdmxCiudad	@oazh
@Cecilia51994130	@oazk
@CedroPeru	@oazw
@CelamWeb	@oazu
@Celebra51837821	@oaze
@CeltiusAbogados	@oazc
@CesarCalderon	@oazv
@Ch14beisd34d	@oazd
@Chamo_0982	@oazr
@Chamo_24_	@oazl
@ChantalCaballe1	@oazt
@Chargerlon	@oazj
@CharoChavez1	@oazp
@ChavezSr140	@oazq
@Chavista_alegre	@oazi
@Cheems_nojao	@oazb
@Chelo_AntonioDV	@oazn
@Chesco_vng	@oazy
@ChileCriminalis	@oazm
@Cholo_Huaman	@oapx
@Chongxi_Bai	@oaps
@ChrisY91354492	@oapg
@Christi36833350	@oapf
@Christian_ESEM	@oaph
@Christiandr92	@oapk
@ChusDark	@oapw
@Chxkzy	@oapu
@CiecaE	@oape
@Cinthilindi	@oapc
@CintraGus	@oapv
@CirculoBurgos	@oapd
@Citytv	@oapr
@CivicanFCN	@oapl
@ClaroColombia	@oapt
@ClaroEcuador	@oapj
@ClauClauClaudio	@oapz
@Claudia45335269	@oapq
@ClaudiaLopez	@oapi
@ClaudioTezas	@oapb
@Cloe45315979	@oapn
@ClubALoficial	@oapy
@CoachMalla	@oapm
@CoberturaFM	@oaqx
@ColinasLAcacias	@oaqs
@Comisionesext	@oaqg
@CommozioniA	@oaqf
@Communist_World	@oaqh
@ComunidadMadrid	@oaqk
@ConasSolid	@oaqw
@ConchiR743	@oaqu
@Conejo1812	@oaqe
@Congreso_Es	@oaqc
@ConsVENBilbao	@oaqv
@ConsueloVegaMS	@oaqd
@ContraT1enpo	@oaqr
@Convent_Gib	@oaql
@CoopPeriferia	@oaqt
@CooperacionAND	@oaqj
@Coophuelva	@oaqz
@CoopsAgroAND	@oaqp
@Copaco3	@oaqi
@CoradoJuanramon	@oaqb
@CordobaCF_ofi	@oaqn
@CornershopChile	@oaqy
@CorteConstEcu	@oaqm
@CorteNacional	@oaix
@CorvoMecanique	@oais
@CosmicCeller	@oaig
@CosmicGaiaX	@oaif
@CostaDelSolNew1	@oaih
@CoviS	@oaik
@CpccsEc	@oaiw
@Crateroccator	@oaiu
@CrazyFeelingFB	@oaie
@CrisQbi	@oaic
@CrisVergara81	@oaiv
@Crisferzpino	@oaid
@Cristian361984	@oair
@CristianBilba12	@oail
@Cristin40156537	@oait
@Cristin86942145	@oaij
@CritasALC	@oaiz
@Cronica_ElMundo	@oaip
@CruzRojaAlmeria	@oaiq
@CruzRojaCordoba	@oaib
@CruzRojaEsp	@oain
@CruzRojaMadrid	@oaiy
@CruzTruckRacing	@oaim
@CryptoNamic	@oabx
@CsMadLatina	@oabs
@CsMalaga	@oabg
@Cs_Diferente	@oabf
@Ctberic0064	@oabh
@Cuatro	@oabk
@Cubillos716	@oabw
@CuchiRaptor	@oabu
@CuentaMister	@oabe
@CuentaParalela	@oabc
@CxdeOKC	@oabv
@Cyandeceres	@oabd
@CynJDC	@oabr
@CynthiaViteri6	@oabl
@D3IIiK	@oabt
@DAVlDqva	@oabj
@DBR8	@oabz
@DDHH_Alianza	@oabp
@DDHH_Ec	@oabq
@DDuelista	@oabi
@DGCGolfClub	@oabn
@DIM_Oficial	@oaby
@DJC_____	@oabm
@DJPoPiZGZ	@oanx
@DKAmbColombia	@oans
@DONANTO17541818	@oang
@DPjr_	@oanf
@DRB189	@oanh
@Dab4121	@oank
@Dalia67444051	@oanw
@DamianCruzG	@oanu
@Damihibibere	@oane
@DaniBordas	@oanc
@DaniCLF1	@oanv
@DaniChavez57	@oand
@DaniMayakovski	@oanr
@Dani_FuriO	@oanl
@Dani__Espadafor	@oant
@DanielGCabrero	@oanj
@DanielGranja7	@oanz
@DanielN21261715	@oanp
@DanielRMed	@oanq
@DanielRodOrd	@oani
@DanielVzqzz	@oanb
@Daniel_Sanz_C	@oany
@Danieldhers	@oanm
@Danielmensilla	@oayx
@Danielsalcan_	@oays
@DanikRM_	@oayg
@DankOficial	@oayf
@Danonin42861699	@oayh
@Dante110624	@oayk
@DanteFontana3	@oayw
@DantePod3n	@oayu
@DanteR86	@oaye
@Dario_Madrid_F	@oayc
@Darjo_C18	@oayv
@DarkknightRight	@oayd
@DatAthle	@oayr
@DavidAragort	@oayl
@DavidGR1714	@oayt
@DavidWlnr	@oayj
@David_Alaba	@oayz
@David_Busta	@oayp
@Daviddddgomez	@oayq
@Dc7069	@oayi
@DcaValle	@oayb
@DeMeison	@oayn
@DeSananton	@oaym
@DeadRabbitsClub	@oamx
@DecadaRobada	@oams
@Declaracion	@oamg
@Defectuosa6	@oamf
@DefensoriaCol	@oamh
@DekuGFX_	@oamk
@DelGobVG	@oamw
@DelfinaMonfort	@oamu
@DeloElmo	@oame
@DelonGregorio	@oamc
@Dembouz7ii	@oamv
@Demoniosaltarin	@oamd
@Demostenes_eu	@oamr
@Desesperanzadoy	@oaml
@DetergenteP	@oamt
@DianAngel01	@oamj
@DianaDvilaNarv1	@oamz
@DianaMunozC	@oamp
@DianitaDelLeon	@oamq
@DiarioElPeruano	@oami
@DiarioOle	@oamb
@Diego75624262	@oamn
@DiegoAlvaradoFe	@oamy
@DiegoArcos14	@oxas
@DiegoFi27933574	@oxag
@DiegoMesaP	@oxaf
@DiegoMovellan	@oxah
@DiegoPg00	@oxak
@DiegoSuarezMed4	@oxaw
@DiegoWyGa	@oxau
@DigbyGeste	@oxae
@DigitalEscudo	@oxac
@DinaBousselham	@oxav
@Diogenes_Jugon	@oxad
@Dioninio	@oxar
@DisneyPlusES	@oxal
@DjMaRiiO	@oxat
@Doct_Tricornio	@oxaj
@DoctorSITHo	@oxaz
@DominiKingCrown	@oxap
@DonDeLibros_	@oxaq
@DonIzquierdo_	@oxai
@DonOso_pe	@oxab
@DonbassMedia	@oxan
@Donkey_5O5	@oxay
@Donpapollas	@oxam
@Donpimpon2011	@oxsa
@DoutorSabe	@oxsg
@DrJete	@oxsf
@Dreamer360X	@oxsh
@DritanAbazovic	@oxsk
@Ds_OutOfContext	@oxsw
@Dubrska_25	@oxsu
@DuendeChifladu	@oxse
@Duke2706	@oxsc
@DukeShelby1	@oxsv
@DukiSSJ	@oxsd
@DvoTachira	@oxsr
@DwPrat	@oxsl
@EAristeguieta	@oxst
@ECFenfurecido	@oxsj
@ECOPETROL_SA	@oxsz
@ECU911_	@oxsp
@EDavidiazubv	@oxsq
@EFE_CValenciana	@oxsi
@EFEnoticias	@oxsb
@EGE1099	@oxsn
@EIGNAHINCAPIE	@oxsy
@ELTIEMPO	@oxsm
@EMCALIoficial	@oxga
@ENGINEER_28	@oxgs
@EP_Social	@oxgf
@ERCVng	@oxgh
@ESTEELSA	@oxgk
@ESTEFANIESPIN	@oxgw
@ESdiarioCV	@oxgu
@Ecce_H	@oxge
@EconoCabreado	@oxgc
@EdL_UB	@oxgv
@Edinho1901	@oxgd
@EditorialUR	@oxgr
@Eduarda70405181	@oxgl
@EduardoChaperon	@oxgt
@EduardoFranjav3	@oxgj
@EdwarLibertad	@oxgz
@EfemeridesArte	@oxgp
@Efrit1Romero	@oxgq
@Eganbernal	@oxgi
@Egotada	@oxgb
@EjercitoTierra	@oxgn
@ElBamba_RM	@oxgy
@ElChe_Gibra	@oxgm
@ElDiarioes	@oxfa
@ElFarodeCeuta	@oxfs
@ElFarodeMelilla	@oxfg
@ElFuns	@oxfh
@ElGatoGrone	@oxfk
@ElHomerSimpsons	@oxfw
@ElHuffPost	@oxfu
@ElMismoYo4	@oxfe
@ElMonoSabio2	@oxfc
@ElNacionalWeb	@oxfv
@ElOjoCriticoRNE	@oxfd
@ElPeriodico_Esp	@oxfr
@ElPitazoTV	@oxfl
@ElRancio_10	@oxft
@ElTransigente	@oxfj
@ElXapaito	@oxfz
@El_LINCE_DE_VOX	@oxfp
@El_Moreno__	@oxfq
@El_Plural	@oxfi
@Eladoscuroh	@oxfb
@Elasombrario	@oxfn
@EldogoHDP	@oxfy
@Eleder_	@oxfm
@ElementalELM	@oxha
@ElenaDeQuito	@oxhs
@ElenaPe07407705	@oxhg
@ElioAndujar	@oxhf
@Elmigue5712	@oxhk
@Elorenovada	@oxhw
@Eltiempoalsur	@oxhu
@Eltrescientas	@oxhe
@EmbEspSenegal	@oxhc
@EmbOrinoco	@oxhv
@EmbQiMei	@oxhd
@EmbajadaRusaES	@oxhr
@Embamexecu	@oxhl
@Emityrell	@oxht
@EmmaRincon	@oxhj
@EmmanuelMacron	@oxhz
@Emocionaelarte	@oxhp
@EnLosLuceros	@oxhq
@EnPraVa	@oxhi
@EnekoHumor	@oxhb
@EnfrmraSaturada	@oxhn
@EnricJuliana	@oxhy
@Enrique31749517	@oxhm
@Enrique_GomezM	@oxka
@Entreculturas	@oxks
@EoiCorunha	@oxkg
@Epicureo64	@oxkf
@EricArthurBlai2	@oxkh
@Eric_Fiorin	@oxkw
@Erict007	@oxku
@EriiicVG	@oxke
@Erikaibarguenr	@oxkc
@Ernesto71225538	@oxkv
@Ernestotaku	@oxkd
@ErrorArbitralTR	@oxkr
@Esautomatix1	@oxkl
@EsojSabir	@oxkt
@Esperanza_nza	@oxkj
@Esperanzabenaya	@oxkz
@Esperoelcambio	@oxkp
@EstebanNavarroS	@oxkq
@Esther32837485	@oxki
@EuroLeague	@oxkb
@Eva30893643	@oxkn
@Evaalejandria1	@oxky
@ExpoIvan	@oxkm
@FAsintomatico	@oxwa
@FBM94	@oxws
@FCBarcelona	@oxwg
@FCBarcelona_es	@oxwf
@FCBayern	@oxwh
@FFAAECUADOR	@oxwk
@FHLatinAmerica	@oxwu
@FIamencia	@oxwe
@FRANGALO4	@oxwc
@FRCERON	@oxwv
@FRVaness	@oxwd
@FSerranoCastro	@oxwr
@FTriangulo	@oxwl
@FXVillarroel	@oxwt
@F_Sanchez_Drago	@oxwj
@Fabian10_	@oxwz
@FabianPicardo	@oxwp
@Fariacrt	@oxwq
@FatimaHHossain	@oxwi
@FatimaRD	@oxwb
@FaustoJarrinT	@oxwn
@FaustoLorenzo	@oxwy
@FelimarmuGmail	@oxwm
@FelipeV_Spain	@oxua
@FerVeneppon	@oxus
@FerchaMafeben	@oxug
@Ferfollos	@oxuf
@Ferkkas	@oxuh
@Fernanda_Mashi	@oxuk
@Fernandoynada	@oxuw
@FestivalViva_22	@oxue
@Feyenoord	@oxuc
@FichajesRSG	@oxuv
@FieraIngenieria	@oxud
@Filipo_Lom	@oxur
@FiorellaLude	@oxul
@FiscaliaEcuador	@oxut
@FiscaliaPeru	@oxuj
@Flash77896822	@oxuz
@FlasheoYT	@oxup
@FlaviaCompany	@oxuq
@FlawlessShot1	@oxui
@Fleky62	@oxub
@Flintstone___	@oxun
@FlorPabloMedina	@oxuy
@FnKiire	@oxum
@FonsiLoaiza	@oxea
@FormasIntimas	@oxes
@Foro_DOculta	@oxeg
@Foxie_GG	@oxef
@FranciaMarquezM	@oxeh
@Francis33813272	@oxek
@Francis98767954	@oxew
@FranciscoRuocco	@oxeu
@FrancoDeVita	@oxec
@Franribas11	@oxev
@FreddyBernal	@oxed
@FreddyGuevaraM	@oxer
@Fredypm	@oxel
@FreeNegus	@oxet
@FreedomHouseLAC	@oxej
@FreeyellowMarta	@oxez
@Fritz_A_Sanchez	@oxep
@FromCaliToMars	@oxeq
@FronteraSur_es	@oxei
@Frutaprohibida0	@oxeb
@FuensantaLM	@oxen
@FuerzaAereaEc	@oxey
@Fum4tr0n	@oxem
@FundaREDES_	@oxca
@FundacionBatuta	@oxcs
@FundacionCepaim	@oxcg
@FundacionEstu	@oxcf
@FundacionRhodes	@oxch
@FundlaCaixa	@oxck
@Futbole51049238	@oxcw
@Futbool_Fotos	@oxcu
@GEPIURosario	@oxce
@GLORIAD_m54_1__	@oxcv
@GLlamazares	@oxcd
@GNBCmdtGral	@oxcr
@GNB_Anzoategui	@oxcl
@GNB_Sucre	@oxct
@GNavasTalero	@oxcj
@GOLPERUoficial	@oxcz
@GSergio12	@oxcp
@GSuspesa	@oxcq
@GTAveledo	@oxci
@GVAcooperacio	@oxcb
@GVAinclusio	@oxcn
@G_Gutenberg	@oxcy
@GabitaBion	@oxcm
@Gabriel71872331	@oxva
@GabrielRuizT	@oxvs
@GabrielaBustelo	@oxvg
@GalileoArms	@oxvf
@GalvaanFN	@oxvh
@GanoACMilan	@oxvk
@GarrinchaCF	@oxvw
@GavoFercho	@oxvu
@GeloGerCan	@oxve
@GemMuay	@oxvc
@GemaBonnin	@oxvd
@GeneralDHodl	@oxvr
@General_RE_Lee	@oxvl
@Generaldepie_	@oxvt
@Gerdanperox	@oxvj
@GersonTaipeN	@oxvz
@Gestionpe	@oxvp
@Ghita_azh	@oxvq
@GibChronSports	@oxvi
@Giiness	@oxvb
@GiovanniCelisS	@oxvn
@GirautaOficial	@oxvy
@GirlsinTech_Ec	@oxvm
@GnbGaranteDePaz	@oxda
@GoYako4	@oxds
@GobArauca	@oxdg
@GobAsturias	@oxdf
@GobiernoTunja	@oxdh
@GobiernodeCeuta	@oxdk
@Gol	@oxdw
@GolfChannelLA	@oxdu
@GomezDominus	@oxde
@GonBernardos	@oxdc
@GoogleNews	@oxdv
@Goro95402106	@oxdr
@GralJuanRamirez	@oxdl
@GranNegrasa	@oxdt
@GrxNuria	@oxdj
@Gsusby	@oxdz
@Guaci20373186	@oxdp
@GuancheNau	@oxdq
@Guayaco_ecuador	@oxdi
@GuidoFinzi	@oxdb
@Guill_os_ama	@oxdn
@GuilleMunoz	@oxdy
@GuillermoGI0403	@oxdm
@Gus_Noriega	@oxra
@GustavoBolivar	@oxrs
@GustavoBolsa	@oxrg
@GustavoVela71	@oxrf
@Gustavo_p4	@oxrh
@Gustavoboscan37	@oxrk
@HARROW_h	@oxrw
@HDPyMedioCDM	@oxru
@HF1970GT	@oxre
@HIAS_ECUADOR	@oxrc
@HOLLMANMORRIS	@oxrv
@HQLovesJoker	@oxrd
@HUS07777781	@oxrl
@Hachecabezas	@oxrt
@Haciendagob	@oxrj
@Hanky_solo	@oxrz
@HannsSeidelCol	@oxrp
@HaxbuR	@oxrq
@HazlosVisibles	@oxri
@HectorAtarrabia	@oxrb
@Hectorgomezh	@oxrn
@HeisenbergWaltB	@oxry
@HelenaMaleno	@oxrm
@HelenaVillarRT	@oxla
@Hendrick_10	@oxls
@HenryNoboaA	@oxlg
@HenryRey91	@oxlf
@Henryyacevedo	@oxlh
@HerneyCruz2	@oxlk
@HernnCortes	@oxlw
@HerrFekken	@oxlu
@HerreraUsagre	@oxle
@HijoDelTruen0	@oxlc
@Hispania_Semper	@oxlv
@HoraAfrica	@oxld
@HoyEliDenuncio	@oxlr
@HtmcIess	@oxlt
@HxIrina	@oxlj
@IAE1959	@oxlz
@IBEVAMSYS	@oxlp
@IB_Franklin	@oxlq
@ICDakar	@oxli
@ICEXCostaMarfil	@oxlb
@IDV_EC	@oxln
@IESRENACIMIENT0	@oxly
@IESSHCAM	@oxlm
@IESSec	@oxta
@IGuttmann	@oxts
@IIuminat	@oxtg
@ISB_VE	@oxtf
@IVANSARNAGO	@oxth
@I_Ketros	@oxtk
@Iazmdrama	@oxtw
@Iberia	@oxtu
@IberoVervuert	@oxte
@IdaniaChirinos	@oxtc
@IdiazAyuso	@oxtv
@IdoiaVR	@oxtd
@IglesiasJulio87	@oxtr
@Ignaciovdm01	@oxtl
@IgualdadAND	@oxtj
@IgualdadGob	@oxtz
@IgualdadLGBT	@oxtp
@IgualdadVallad1	@oxtq
@IjonTichy3	@oxti
@ImPaDnA2002	@oxtb
@InakoDiazGuerra	@oxtn
@IndecopiOficial	@oxty
@IndigoyAzul	@oxtm
@IndosIgnacio	@oxja
@InfoFreestyle2	@oxjs
@InfoGibraltar	@oxjg
@InfoGocho	@oxjf
@InstMujeres	@oxjh
@Internews	@oxjk
@Internews_AMER	@oxjw
@InvictosSomos	@oxju
@IpsosSpain	@oxje
@IrantzuVarela	@oxjc
@IreneMontero	@oxjv
@IsabelFraca	@oxjd
@IsabelIsamoren	@oxjr
@Isabel_EJ	@oxjl
@Isherwood75	@oxjt
@IskraElectrica	@oxjz
@Isma202020	@oxjp
@Itacamed	@oxjq
@IvanCepedaCast	@oxji
@IvanDuque	@oxjb
@IvanEdlRaneros	@oxjn
@IvanRubia1	@oxjy
@Ivancit89272232	@oxjm
@Ivanjode	@oxza
@IvonneMilenaGo	@oxzs
@IzanagiGon	@oxzg
@IzarraldeT	@oxzf
@IzquierdaPe	@oxzh
@J1_aguad	@oxzk
@JACOBOSOLANOC	@oxzw
@JA_DelgadoRamos	@oxzu
@JBCPERU	@oxze
@JC_C_A	@oxzc
@JFCaicedolvarez	@oxzv
@JFKGUANCHE	@oxzd
@JFernandezTrigo	@oxzr
@JIDominguezFMD	@oxzl
@JKALvellido	@oxzt
@JL_Muros_	@oxzj
@JLambanM	@oxzp
@JMDLatina	@oxzq
@JMalaparte	@oxzi
@JMonteroK9	@oxzb
@JPGVS_	@oxzn
@JPPir	@oxzy
@JPSalmeronL	@oxzm
@JR64745539	@oxpa
@JRG9119	@oxps
@JRpovedaF	@oxpg
@JVLazarus	@oxpf
@J_Impressionism	@oxph
@J_J_A_A_	@oxpk
@J_Kidd17	@oxpw
@J_Upegui	@oxpu
@J_rechola	@oxpe
@JackEscutia1	@oxpc
@JacoDiazAlejano	@oxpv
@JacoboG_Ecu	@oxpd
@Jadouken10	@oxpr
@JaeDorante	@oxpl
@Jamg18Josr	@oxpt
@Jandra44	@oxpj
@JaredSukukhin	@oxpz
@JasanMargas18	@oxpq
@JaviLin63	@oxpi
@JaviSantamarta	@oxpb
@Javier82632911	@oxpn
@JavierABallen	@oxpy
@JavierArocaA	@oxpm
@JavierMartinr1	@oxqa
@JavierSanz	@oxqs
@JavierVillamor	@oxqg
@Javier_Mantrana	@oxqf
@Javiergaciaisac	@oxqh
@Javis_vegas	@oxqk
@JaylanHankins	@oxqw
@Jdechill	@oxqu
@JeanVal10474721	@oxqe
@Jefferson_Diaz	@oxqc
@Jeison_HeroeCNN	@oxqv
@Jelizackie	@oxqd
@Jenire30	@oxqr
@Jerocantillo	@oxql
@Jessi_Lara24	@oxqt
@JessicaPk18	@oxqj
@Jessy49867853	@oxqz
@Jesus26591370	@oxqp
@JesusCintora	@oxqi
@JesusEnr17	@oxqb
@JesusNavarro	@oxqn
@Jgs928	@oxqy
@JhonattanVegas	@oxqm
@JoanSeguidor	@oxia
@JoaquimBoschGra	@oxis
@Joe84801268	@oxig
@JoeBiden	@oxif
@JohanaLuchini	@oxih
@Johnny90VM	@oxik
@JohnnyDogsX	@oxiw
@Jokinruizkor	@oxiu
@Jomaca18	@oxie
@JonaOlmoAlb	@oxic
@JordiN_Zaragoza	@oxiv
@Jordi_Ferrer	@oxid
@Jordi_Saldo	@oxir
@JorgeDimitrof	@oxil
@JorgeLuisPrez2	@oxit
@Jorge_Serrote	@oxij
@JosAndrsP1	@oxiz
@JosCarlosGmez7	@oxip
@JosGOSALBEZ1	@oxiq
@JosPastr	@oxib
@JoseAGraterol	@oxin
@JoseFig15360647	@oxiy
@JoseLFe64305298	@oxim
@JoseManicas	@oxba
@JoseXavierSama1	@oxbs
@Jose_Vazquez112	@oxbg
@Josedetemple	@oxbf
@Josevi54759814	@oxbh
@JosueBa59432478	@oxbk
@JuampaSantos	@oxbw
@Juan79584891	@oxbu
@JuanAndrsRoser2	@oxbe
@JuanCar66988968	@oxbc
@JuanCar74131719	@oxbv
@JuanDavidMeteo	@oxbd
@JuanMa_Moreno	@oxbr
@JuanMaches	@oxbl
@JuanManSantos	@oxbt
@JuanMartinDrago	@oxbj
@Juan_Acosta_Gar	@oxbz
@Juana85401525	@oxbp
@Juanaafanador1	@oxbq
@Juancorreillo	@oxbi
@Juande_elx1983	@oxbn
@Juanfabre1308	@oxby
@JuanjoCotilla	@oxbm
@Juanjos73843721	@oxna
@Juankaboa	@oxns
@Juanma7115	@oxng
@Juanma_Saez	@oxnf
@Juanmarimanero	@oxnh
@Juanparal	@oxnk
@JuanraGciaRico	@oxnw
@Juantesillo_	@oxnu
@JuliaBayo1	@oxne
@JuliaCorreaNutt	@oxnc
@JulianCardenal_	@oxnv
@JulianDavidRe15	@oxnd
@JulianGarrido97	@oxnr
@JulianMaciasT	@oxnl
@JulioBorges	@oxnt
@JulioEc62725505	@oxnj
@JulioMartnezFo1	@oxnz
@JulioTupac	@oxnp
@JulliethCano	@oxnq
@JuntaAsturias	@oxni
@JuntaCordoba	@oxnb
@JuntsxCatMadrid	@oxny
@JuridycaCarlos	@oxnm
@Jusluckn	@oxya
@JuventudRC5_	@oxys
@JuventudUCE	@oxyg
@KMasllorens	@oxyf
@KOA_KOA_KOA	@oxyh
@KaPaK38	@oxyk
@Kakashi__13	@oxyw
@Kali_si	@oxyu
@KamiKaz67046218	@oxye
@Kansaden_95	@oxyc
@Karla_Mi_Polola	@oxyv
@KarollaN2	@oxyd
@KaseO_real	@oxyr
@KatanaJanso	@oxyl
@Kattito_uwu	@oxyt
@KayMishi	@oxyj
@KeikoFujimori	@oxyz
@KerazoPenta	@oxyp
@KhintiIa	@oxyq
@KieseErwin	@oxyi
@Klaus_Arminius	@oxyb
@Klobo91	@oxyn
@KludO_	@oxym
@KowalskiGDTD	@oxma
@KpuPiano	@oxms
@Krupskaya_1869	@oxmg
@Kufrus1	@oxmf
@KyroxSP	@oxmh
@LAYOLYRM	@oxmk
@LDSoficial	@oxmw
@LDU_Oficial	@oxmu
@LFB121292	@oxme
@LHMadr	@oxmc
@LITORALPRESS	@oxmv
@LOLA_CULE	@oxmd
@LQSomos	@oxmr
@LRsecreta	@oxml
@LZCOficial	@oxmt
@L_Badell	@oxmj
@LaBella_2017	@oxmz
@LaClaveNoticias	@oxmp
@LaEtxebarria	@oxmq
@LaGalaxiaEspera	@oxmi
@LaGranNoticia	@oxmb
@LaGuerreraHdp	@oxmn
@LaHoraTVE	@oxmy
@LaIzqDiarioMX	@osax
@LaLadil30301091	@osag
@LaLiga	@osaf
@LaPatillaRouge	@osah
@LaPosta_Ecu	@osak
@LaRegente_	@osaw
@LaSalitadelSin	@osau
@LaUnikatv	@osae
@LaVozdeCadiz	@osac
@La_SER	@osav
@LabeguerreCesar	@osad
@LacambraSerrano	@osar
@Lagiacrus206	@osal
@Lalo853	@osat
@Lampiao82	@osaj
@Lasdetrfle1	@osaz
@LassoGuillermo	@osap
@LassoMusica	@osaq
@Latina_Noticias	@osai
@Latina_pe	@osab
@Latinos_2021	@osan
@Laura_PG_	@osay
@Lazaril56386213	@osam
@Legadema_85	@osxa
@LeninArtieda	@osxg
@Lentejitas	@osxf
@Leometry_	@osxh
@LeonVaLenciaA	@osxk
@LeonelJara7	@osxw
@LeonidasIzaSal1	@osxu
@LesVerts	@osxe
@LeticiaDolera	@osxc
@Liber35314473	@osxv
@LiberaGerona	@osxd
@Lidio_Dominante	@osxr
@Liebherr	@osxl
@LiguistaOficial	@osxt
@LiliMuVe	@osxj
@LilianaJLira	@osxz
@Lina97510555	@osxp
@LindoSindo	@osxq
@Lineamadrid	@osxi
@LiteraturaDepor	@osxb
@LobbyAlgarvio	@osxn
@Lokiizhabbo	@osxy
@LolaShultz	@osxm
@Lolobarreiro	@osga
@Lopezjr2801	@osgx
@LoretoConventGI	@osgf
@LosPajarosPican	@osgh
@Louella_Parsons	@osgk
@Loveisl93728166	@osgw
@LpAdriii	@osgu
@LuaLipaa	@osge
@Lucasbarreraf	@osgc
@LuciaAlvites	@osgv
@LuigiChetes	@osgd
@Luis66125	@osgr
@LuisAlb46595022	@osgl
@LuisGilAlonso	@osgt
@LuisM_1924	@osgj
@LuisMadrid2	@osgz
@LuisRFuentes32	@osgp
@LuisaGonzalezEc	@osgq
@Luisperezdayala	@osgi
@Lushka83020544	@osgb
@LuzO_	@osgn
@LuzSalgado_R	@osgy
@Luz_Sela	@osgm
@Luz__0226	@osfa
@LxtinoGang	@osfx
@MAECgob	@osfg
@MAR222001	@osfh
@MARGAconG	@osfk
@MCarmenPFSanse	@osfw
@MFA_Austria	@osfu
@MGabriela23	@osfe
@MGermenes	@osfc
@MGolondrinart	@osfv
@MJ02011970	@osfd
@MLLACOUTURE	@osfr
@MLSes	@osfl
@MLiberal_es	@osft
@MMartinez__1	@osfj
@MOrdonezLara	@osfz
@MPreatoni	@osfp
@MRiveRR1	@osfq
@MV46500583	@osfi
@Ma89778174	@osfb
@MaElviraSalazar	@osfn
@MaFePerdomoA	@osfy
@MacMusik	@osfm
@Macarena_Olona	@osha
@Macavit_y	@oshx
@Madeinspain13	@oshg
@Madrid4Citizens	@oshf
@MadridTormenta	@oshk
@MafeCarrascal	@oshw
@MagistraThor	@oshu
@MaikelLucena9	@oshe
@MaisonKendall	@oshc
@MalagaCF	@oshv
@Mali_Melus	@oshd
@MalvadaLiberal	@oshr
@Mamayprofesora	@oshl
@Mamenjg12	@osht
@Mamertos0	@oshj
@Mamertuit	@oshz
@ManNextDoor	@oshp
@ManaguaFuriosa	@oshq
@MangelGH	@oshi
@Manolo16715449	@oshb
@ManuNorambuena	@oshn
@Manu_sigurimi	@oshy
@ManuelAres_	@oshm
@ManuelJTejero	@oska
@ManuelLeonlopez	@oskx
@MarDGamero	@oskg
@MarEspesOjea	@oskf
@MarataTabarnesa	@oskh
@Marbelle30	@oskw
@MarcFerre_Cat	@osku
@MarcKlein_	@oske
@MarceloHenao_	@oskc
@Marcore_Aron	@oskv
@Marcos_MI7	@oskd
@MarcosdeQuinto	@oskr
@Marcosenpai95	@oskl
@MardeRojan	@oskt
@MareaDante	@oskj
@Marga_Maria_	@oskz
@MargaritaBandal	@oskp
@Margaritarosadf	@oskq
@Maria46113062	@oski
@Maria51843568	@oskb
@MariaCAlvarezS	@oskn
@MariaCorinaYA	@osky
@MariaFdaCabal	@oskm
@MariaMu24417972	@oswa
@MariaOlga12	@oswx
@Maria_EstevezG	@oswg
@Maria_Lama	@oswf
@Mariazell2	@oswh
@MarieFrettoloso	@oswk
@Marihw77	@oswu
@Mariiobross_	@oswe
@Marina_agbb	@oswc
@MarioCortegana	@oswv
@MarioNolio	@oswd
@MarotoReyes	@oswr
@Marques_Ze_	@oswl
@Marshall_Flash	@oswt
@Marta_Ferrer	@oswj
@Marthausacol	@oswz
@MartinNicolas97	@oswp
@MartinQuiSa12	@oswq
@MartinRightOn	@oswi
@MartinaVelardeG	@oswb
@Martinminguchi	@oswn
@Martuflis1	@oswy
@Marwanmusica	@oswm
@Marxista_NBA	@osua
@MaryPer13375153	@osux
@Marynabou	@osug
@MasLatina_	@osuf
@MashiRafael	@osuh
@MassCamilo	@osuk
@Mauro_dorta	@osuw
@Mav_erick2	@osue
@Mayralegamboa	@osuc
@MazelLilith	@osuv
@McCainInstitute	@osud
@McDL_TuBB	@osur
@Medicilio	@osul
@MeganeMercury	@osut
@Meister1508	@osuj
@MerayoJorge	@osuz
@MeteoCanalSur	@osup
@MeteoGib	@osuq
@MeybeDom	@osui
@MiSolLlanero	@osub
@Mibelis	@osun
@MicheleenFlynn	@osuy
@MigeruH	@osum
@Migmez	@osea
@MigracionCol	@osex
@MigracionesPe	@oseg
@Migraciones_AR	@osef
@Miguel20_2012	@oseh
@MiguelGTormo	@osek
@MiguelLuisSanz1	@osew
@Miguel_bajoara	@oseu
@Mike11Caporale	@osec
@MillosFCoficial	@osev
@MiltonFriedom5	@osed
@MinCulturaPe	@oser
@MinGobiernoEc	@osel
@MinSaludCol	@oset
@Mine759	@osej
@MinerNava	@osez
@MinistCorreista	@osep
@Minochos	@oseq
@MissSofi21	@osei
@MisterEspeto	@oseb
@Mitsyssa	@osen
@Miuelino	@osey
@Mnica01163438	@osem
@Mobutu_ruru	@osca
@Mocho_Escoba	@oscx
@MohMar	@oscg
@MohamedFatimetu	@oscf
@MondoXboxEsp	@osch
@MonederoJC	@osck
@MonicaCarrillo	@oscw
@MonicaExt	@oscu
@Monica_Garcia_G	@osce
@Monicafrancopom	@oscv
@Monle85	@oscd
@MontassarRahal	@oscr
@MoraVicenteLuis	@oscl
@Moraddd_	@osct
@Moradell_11	@oscj
@Morafanova	@oscz
@MorawieckiM	@oscp
@Motard8559	@oscq
@MoussaBk	@osci
@MovimientoxlPaz	@oscb
@Movistar	@oscn
@MovistarCo	@oscy
@MrEggSrOu	@oscm
@MrKaytos	@osva
@MrLombreeze	@osvx
@MrWanuel_ESO	@osvg
@Mr_morq	@osvf
@Mrsambo92	@osvh
@Mrtxu1	@osvk
@Mrxsrp	@osvw
@Muhammad___ebb0	@osvu
@MuniLima	@osve
@MunicipioQuito	@osvc
@MuseoThyssen	@osvd
@My_new_lifeeeee	@osvr
@N3l1nh0	@osvl
@NASA_es	@osvt
@NATO	@osvj
@NEPAD_Agency	@osvz
@NYSE	@osvp
@N_Med	@osvq
@NachitoTV	@osvi
@Nando_Lopez_	@osvb
@Nanosecso	@osvn
@Napalm4Breakfas	@osvy
@NapoDainamait	@osvm
@NastiencaO	@osda
@NatGeo	@osdx
@Nattbecquer	@osdg
@Navarrameteo	@osdf
@Navymat	@osdh
@NayaVeira	@osdk
@NayaraSurvivor	@osdw
@Ncoviedo	@osdu
@NelksonBSI	@osde
@Nelsonpvzla1	@osdc
@Neopaurario	@osdv
@NestorMGH	@osdr
@NestorMoralesC	@osdl
@NestorRego	@osdt
@NetflixES	@osdj
@Newtral	@osdz
@Nex72599860	@osdp
@NicoBolivariano	@osdq
@NicolasMaduro	@osdi
@Niko10421326	@osdb
@Nilsons92	@osdn
@NoKroti19	@osdy
@NoSoyJavier_	@osdm
@NoVive_Socialis	@osra
@NoaGresiva	@osrx
@Noe_de__Noelia	@osrg
@Nomentiendas	@osrf
@NoorAlamarty	@osrh
@Noproblem05	@osrk
@NormaYarrow4	@osrw
@Nosabenligar	@osru
@NotJanz	@osre
@Noticias	@osrc
@NoticiasCaracol	@osrv
@NoticiasRCN	@osrd
@Nrvaldivia5	@osrl
@NubeDeAgua80	@osrt
@NuestraEspana_	@osrj
@NvCheeXx	@osrz
@NymeriaSolo	@osrp
@OIMColombia	@osrq
@OIMEcuador	@osri
@OIM_Peru	@osrb
@OJOVENE	@osrn
@ONUMujeres	@osry
@ONUPeru	@osrm
@ONU_es	@osla
@OOCprogresismo	@oslx
@ORZOWEI2000	@oslg
@ORamosBets	@oslf
@OSIPTEL	@oslh
@OSilenciosa	@oslk
@OTAN	@oslw
@OV_URosario	@oslu
@OXKAR_U	@osle
@Observe50000564	@oslc
@OfpunkSons	@oslv
@Okivader	@osld
@OlgaJiSe	@oslr
@OmarOrostegui	@oslt
@Omnia_Somnia	@oslj
@OndaCero_es	@oslz
@One2022Special	@oslp
@OperadorNuclear	@oslq
@Opinado29094843	@osli
@OpinadorProfes4	@oslb
@OptimusPrime65	@osln
@Ordu_0510	@osly
@OrlandoDobleU10	@oslm
@Orocline	@osta
@Ororo_Pride	@ostx
@OscarAMontoyaJ	@ostg
@OscarCruzCastro	@ostf
@OskarMatute	@osth
@Oskartxuprz	@ostk
@Osman56398887	@ostw
@OttoEMezzo86	@ostu
@OumouSangare	@oste
@OussamaIdrissi_	@ostc
@PAEecuador	@ostv
@PALKRAJO2	@ostd
@PArbide	@ostr
@PGN_COL	@ostl
@PHiperactivo	@ostj
@PICHI_FLOR	@ostz
@PInconcreto	@ostp
@PJoliCo	@ostq
@PLP_Ezeiza1	@osti
@PLuz_7_	@ostb
@PNUDEcuador	@ostn
@PODEMOS	@osty
@POZI1972	@ostm
@PSOE	@osja
@PSOE_AytoVLL	@osjx
@Pablo21101	@osjg
@PabloCamPiq	@osjf
@PabloEchenique	@osjh
@PabloIglesias	@osjk
@PabloMatta11	@osjw
@PabloPerez1000	@osju
@Pablo_Alarcon	@osje
@Pabloquinterove	@osjc
@Pablosanchezvol	@osjv
@PachoSantosC	@osjd
@PacoHernando2	@osjr
@PacoSevillaC	@osjl
@PacoUDS_23	@osjt
@PacoVonJamesVon	@osjz
@Paco_Aznar_	@osjp
@Pacohavuelto	@osjq
@PactColombia	@osji
@PadreHuerfano1	@osjb
@Palavecini5ta	@osjn
@Palmaradio	@osjy
@PalomaValenciaL	@osjm
@Palrom1	@osza
@PamLaGata2	@oszx
@PartidoMIRA	@oszg
@PartidoMorenaMx	@oszf
@PartidoPSUV	@oszh
@PascualRosser	@oszk
@Pascual_Return	@oszw
@Pasescoon	@oszu
@PatColon	@osze
@PatoFdez	@oszc
@Patrici76142410	@oszv
@PatriciaShea53	@oszd
@Patro48613356	@oszr
@Patufet5	@oszl
@PatxiFreytez	@oszt
@Patxito	@oszj
@PauloLondra	@oszp
@PausolinaP	@oszq
@Pedro47276558	@oszi
@PedroCastilloTe	@oszb
@PedroChang10	@oszn
@Pedroleko	@oszy
@PeiBasque	@oszm
@Peio_72	@ospa
@PelandoElOjo_	@ospx
@PensarPublico	@ospg
@PepComellas4	@ospf
@PepetoNro0	@osph
@Per_Energia	@ospk
@PercyCastillo	@ospw
@Periodistadigit	@ospu
@Perreneitor	@ospe
@PerroUsuario	@ospc
@PersonajeDTurno	@ospv
@Perugae	@ospd
@PerujoMaria	@ospr
@Pet3rJ	@ospl
@PeterDraft	@ospt
@PeterLangGroup	@ospj
@PetroGustavo	@ospz
@PichiBlu_e	@ospq
@PiedadGonzlez84	@ospi
@PieriSalvatore	@ospb
@Pikachuche	@ospn
@PilarJCifuentes	@ospy
@Pilar_Serrano_G	@ospm
@Pildora_II	@osqa
@Pilicar3	@osqx
@PinVinpez	@osqg
@PinoCalad	@osqf
@PixelitoL_	@osqh
@Pizarro1478	@osqk
@PizarroMariaJo	@osqw
@Plan_Ecuador	@osqu
@Planeta_Futuro	@osqe
@PodemosMelilla	@osqc
@PoderAccionSoci	@osqv
@PoderJudicialEs	@osqd
@PoetaRubencho	@osqr
@PoleoRafael	@osql
@PoliciaBogota	@osqt
@PoliciaBquilla	@osqj
@PoliciaColombia	@osqz
@PoliciaEcuador	@osqp
@PoliciaPeru	@osqi
@Polificcion	@osqb
@PoligonoEl	@osqn
@PolimaWestcoast	@osqy
@Poliorcetes	@osqm
@PoliticaUR	@osia
@PollitaSideral	@osix
@PolloMoralesEC	@osig
@Pontifex_es	@osif
@Porti84	@osih
@PreacherFCB	@osik
@PremiosPopis	@osiw
@PrimeVideoES	@osiu
@PrimeraPlanaECU	@osie
@PrimeraRFEF	@osic
@Primicias	@osiv
@PrivatPabLibRV8	@osid
@ProcesoQ	@osir
@ProfdeCaliches	@osil
@Prooteoo	@osit
@ProtoPlasmannn	@osij
@PuigdeBolt	@osiz
@Pun1sh3r74x	@osip
@PuntodeFuga	@osiq
@Puntodequiebr15	@osib
@PuroLatinoFest	@osin
@PutoDecente	@osiy
@PutoMikel	@osim
@PybrAlex	@osba
@QuanticAngel	@osbx
@QueNino	@osbg
@QuimTorraiPla	@osbf
@QuinteroCalle	@osbh
@QuitenoSur	@osbk
@R64ju	@osbw
@RAEinforma	@osbu
@RAYMKIII1	@osbe
@RC5Oficial	@osbc
@RC5Pichincha	@osbv
@RCD_Mallorca	@osbd
@RCNT_BALONCESTO	@osbr
@RCamachoVzla	@osbl
@RCarrascoQueen	@osbt
@RCiudadana_EC	@osbj
@RCivil_Zona5	@osbz
@REDROJA4	@osbp
@REVENGE_CN_	@osbq
@REjercitos	@osbi
@RFFM_oficial	@osbn
@RICOCARTY	@osby
@RJM_LAC	@osbm
@RLynxes	@osna
@RMBaloncesto	@osnx
@RNBPColombia	@osng
@RPPNoticias	@osnf
@RParragaPFP	@osnh
@RRIIMovilidadAN	@osnk
@RRViosca	@osnw
@RSCruzRojaMad	@osnu
@RTVCnoticias	@osne
@RacoCB	@osnc
@RadamsGonzlez2	@osnv
@RadioTaronja_	@osnd
@RafaArjonaT	@osnr
@RafaBarakaTV	@osnl
@RafaNietoLoaiza	@osnt
@RafaSorianoO	@osnj
@Raga1308	@osnz
@RaisaCorral	@osnp
@RaistlindMajere	@osnq
@Ramn05497657	@osni
@RamonNogueras	@osnb
@Ramon_Letrado	@osny
@RandomG83695914	@osnm
@RaulEspinelDED	@osya
@RaulZambrano7	@osyx
@Razgrizdmon	@osyg
@RealBetis	@osyf
@Rebeka80721106	@osyh
@RecasensJM	@osyk
@RecunchosDe	@osyw
@RedRobot64	@osyu
@RedSoxBeisbol	@osye
@RegistroCivilec	@osyc
@Regoteos	@osyv
@Reimago315	@osyd
@ReligionesPaz	@osyr
@Renezzbro	@osyl
@ReniecPeru	@osyt
@RepCarlos	@osyj
@RepublicaNow	@osyz
@Resiliencia1371	@osyp
@ResistenA	@osyq
@Resistenci1	@osyi
@RevistaSemana	@osyb
@Rhettinred	@osyn
@Ricardito2022	@osym
@Ricardo_Hispano	@osma
@Ricardo_Vanegas	@osmx
@Rideer_023	@osmg
@RiojanaInma	@osmf
@RiquiPuig	@osmh
@Rita_Maestre	@osmk
@RizitoSpain	@osmw
@Roberta36519391	@osmu
@Roberto10633062	@osme
@RobertoAlcaza31	@osmc
@RobertoAzaldeg2	@osmv
@RobertoPatino	@osmd
@Roberto_Ordas	@osmr
@Robotic80960225	@osml
@RockFM_ES	@osmt
@RocketClassic	@osmj
@Rockolate	@osmz
@RodrigollSD	@osmp
@RogelJonatan	@osmq
@Rogelita_	@osmi
@Roi180393	@osmb
@RoiLopezRivas	@osmn
@RolandoySuCueva	@osmy
@RollDiceBot	@ogax
@RoloAL1901	@ogas
@RosaVillacastin	@ogaf
@Rosbelydelmar1	@ogah
@RositoTheBear	@ogak
@Rovietnam	@ogaw
@RrdRocio	@ogau
@RubenSanchezTW	@ogae
@Rubio_sin_bote2	@ogac
@RumoreFutbol	@ogav
@S	@ogad
@SABATERCHAPARRA	@ogar
@SALG593	@ogal
@SANTIAGOLMB	@ogat
@SEspindolaEc	@ogaj
@SEstadoMigr	@ogaz
@SF_Moro	@ogap
@SNIB46	@ogaq
@SOFIS_BLANCO239	@ogai
@SOSOrinoco	@ogab
@SRE_mx	@ogan
@SUCIALISM0	@ogay
@SXTrece	@ogam
@S_Rabinal	@ogxa
@Sae10RM	@ogxs
@SagSenasaHn	@ogxf
@SalimkAL	@ogxh
@SaludAPCordoba	@ogxk
@Salud_CZ9	@ogxw
@SalvadorQuishpe	@ogxu
@Samurai29464219	@ogxe
@SanabriaTatiana	@ogxc
@SandraC22228290	@ogxv
@SandraDerecha	@ogxd
@SaninPazC	@ogxr
@SantanderFund	@ogxl
@SantiNunez	@ogxt
@Santi_ABASCAL	@ogxj
@Santorcaz	@ogxz
@Santsfree3	@ogxp
@SaraTufanoZ	@ogxq
@Saragonlopez	@ogxi
@Sargo_Senegal	@ogxb
@SbastienMlires1	@ogxn
@ScarecrowSong	@ogxy
@SebaChittadini	@ogxm
@Sebasti56040209	@ogsa
@SebastianNohra	@ogsx
@SebastianaB	@ogsf
@Sebastianblurr	@ogsh
@SecBlinken	@ogsk
@SectorMovilidad	@ogsw
@SeguridadBOG	@ogsu
@SenadoGovCo	@ogse
@Senadoesp	@ogsc
@Senekifgc	@ogsv
@SenseMurs	@ogsd
@SentimientoM	@ogsr
@Sera04220630	@ogsl
@SerdnaSare	@ogst
@SergioGuzmanE	@ogsj
@SergioSerranoCM	@ogsz
@SergioVargas137	@ogsp
@Sergio_Vegas	@ogsq
@Serigne_Mbaye_	@ogsi
@Serpalitonia	@ogsb
@SevillaFC	@ogsn
@Sheltonclyde_	@ogsy
@ShemaleVibe	@ogsm
@Sidecarsrock	@ogfa
@SiemprePichaco1	@ogfx
@SienpreEsp	@ogfs
@SikaSpain	@ogfh
@SillitaBasada	@ogfk
@SinCensuraCol	@ogfw
@SinfacturaP	@ogfu
@Singlot3	@ogfe
@Sinolodigo2	@ogfc
@SirGalio	@ogfv
@SlmSumia	@ogfd
@SocialDrive_es	@ogfr
@Sokreter	@ogfl
@Soldadocristia3	@ogft
@Solid_Pizza	@ogfj
@Sombra582	@ogfz
@SomosPanasCol	@ogfp
@SonJoven	@ogfq
@SonnyChibani	@ogfi
@SopetranBoy	@ogfb
@SophiMuller	@ogfn
@SoyAliciaFranco	@ogfy
@SoyCastillo593	@ogfm
@SoyJesusTarre	@ogha
@SoyNan28	@oghx
@Soyandreab21	@oghs
@SpanischerKerl	@oghf
@Spetsnaz2022	@oghk
@Spiriel1	@oghw
@SportielloLilia	@oghu
@SpreenDWC	@oghe
@SprintDeRakitic	@oghc
@Spurs_ES	@oghv
@Spursito	@oghd
@SputnikRT2022	@oghr
@Sputnik_lll	@oghl
@SrCuero2	@oght
@SrPiell	@oghj
@SraAbsurdez	@oghz
@StarliteCatOcc	@oghp
@StatePRM	@oghq
@Stateyler	@oghi
@StevenLinares4	@oghb
@StockholmPlus50	@oghn
@Stopglobalism0	@oghy
@StripMarvel	@oghm
@Stupid_Rental	@ogka
@Sturlunson	@ogkx
@SubotaiBaatur	@ogks
@Sudamericana	@ogkf
@SueldoPublico	@ogkh
@Supersalud	@ogkw
@SurkunaEc	@ogku
@SusanaSpa	@ogke
@Susususukkk	@ogkc
@TAGHeuer	@ogkv
@TDiosn	@ogkd
@TGVINOUI	@ogkr
@TREVII17	@ogkl
@TRON_KE_T	@ogkt
@TSAlgerie	@ogkj
@TXOPO_22	@ogkz
@Tabarnesandaluz	@ogkp
@Tabernita	@ogkq
@TachiraNoticias	@ogki
@Taka_Fernandez	@ogkb
@TakeoffBriefing	@ogkn
@Talamaniaa	@ogky
@TalebSahara	@ogkm
@Talento_Zero_	@ogwa
@TaniaCris12	@ogwx
@TaniaRamirezCo	@ogws
@TaufigZ	@ogwf
@TeamRojas45	@ogwh
@Teleantioquia	@ogwk
@TelloBJr	@ogwu
@TendamRetail	@ogwe
@Teresa_Peyres	@ogwc
@TeresitaDeLaO	@ogwv
@TerrasdeLugo	@ogwd
@Thabatica	@ogwr
@TheBarberCadiz	@ogwl
@TheFunambulist_	@ogwt
@TheGentlemanACB	@ogwj
@TheObjective_es	@ogwz
@Theainsliegoat	@ogwp
@TheeEmpiire	@ogwq
@Thesaint931	@ogwi
@ThiagoScap	@ogwb
@ThreeMagicStorm	@ogwn
@TiempoCyLTV	@ogwy
@TiempoRealEC	@ogwm
@Tierradehombres	@ogua
@TigrilloTW	@ogux
@TinaDuckbill	@ogus
@Titoanselm	@oguf
@TocateLaPeineta	@oguh
@TomELawrence1	@oguk
@TomaLaPalabraVA	@oguw
@Toma_Unica	@ogue
@Tomi_cac15	@oguc
@Tomillar63	@oguv
@ToniRocaT	@ogud
@ToniRuediger	@ogur
@Toni_Marco	@ogul
@TonichanPiedra	@ogut
@TooBlanco16	@oguj
@TopoBalaidos	@oguz
@Tortilla_Land	@ogup
@TotoyElFrio	@oguq
@TouringTest	@ogui
@TransMilenio	@ogub
@TransitoBta	@ogun
@Tremending	@oguy
@TrencoRosa	@ogum
@TrevvieAAMB	@ogea
@Tropatriunfante	@ogex
@TsaoSSJ	@oges
@Tssss666	@ogef
@Tupungato78	@ogeh
@TurDepuLugo	@ogek
@Turgalicia	@ogew
@TusquetsEditor	@ogeu
@TvlEcuador	@ogec
@TwitteandoHE	@ogev
@TwitterEspana	@oged
@TyelpeIthildim	@oger
@Tyrion019	@ogel
@UAlfonzo	@oget
@UAutonomaNorte	@ogej
@UCEspana	@ogez
@UCM_fghis	@ogep
@UEenPeru	@ogeq
@UEenVenezuela	@ogei
@UGT_Comunica	@ogeb
@UNESCO	@ogen
@UNESECUADOR	@ogey
@UNHCRGirard	@ogem
@UNODC_ROPAN	@ogca
@UNRWAes	@ogcx
@UOCbiblioteca	@ogcs
@UPFBarcelona	@ogcf
@URInternacional	@ogch
@UR_Regiones	@ogck
@URinvestigacion	@ogcw
@URosario	@ogcu
@USAID_Colombia	@ogce
@USAenEspanol	@ogcv
@USTreasury	@ogcd
@USembassyMadrid	@ogcr
@UVa_es	@ogcl
@UldaricoChilito	@ogct
@UnRatoAmeno	@ogcj
@UnchainedClau	@ogcz
@Uniandes	@ogcp
@UnionEuropeaRD	@ogcq
@Universitario	@ogci
@UnmoroconDNI	@ogcb
@UyLuis	@ogcn
@VENEZUELAIndep1	@ogcy
@VLADIMIR_CERRON	@ogcm
@VOXBELLATOR1	@ogva
@VOXLaLatina1	@ogvx
@VOXvalenciaciud	@ogvs
@VSumergida	@ogvf
@Vadodecaza1	@ogvh
@ValorDolarBlue	@ogvk
@VandaloDelSur	@ogvw
@Varshyll	@ogvu
@VayaMentira	@ogve
@VazquezTian	@ogvc
@VctorBlasc	@ogvd
@VdeVendetta	@ogvr
@VelhoXaringado	@ogvl
@Venereal14	@ogvt
@VerdugaAbraham	@ogvj
@Verguelethor	@ogvz
@VeronicaOvies	@ogvp
@Veronicalcocerg	@ogvq
@Vicente73977721	@ogvi
@VicenteQuilis1	@ogvb
@Vicenteaojeda	@ogvn
@VickyDavilaH	@ogvy
@VickyGMN	@ogvm
@VickyRosell	@ogda
@Vickyquinta	@ogdx
@VictorBardisa	@ogds
@VictorSilvaVE	@ogdf
@Vidadebohemia	@ogdh
@VidalQuadras	@ogdk
@Viktor_81	@ogdw
@VincentVega677	@ogdu
@VioletaCandela5	@ogde
@Vissibles	@ogdc
@ViudaNegra39	@ogdv
@ViviamSarita83	@ogdr
@VivianIdrovo	@ogdl
@VividosMomentos	@ogdt
@Vladimir1811	@ogdj
@Volaverunt91	@ogdz
@VoxDavidgarcia	@ogdp
@VoxMurciaCiudad	@ogdq
@VoxZaragoza	@ogdi
@WFP	@ogdb
@WHO	@ogdn
@WRadioColombia	@ogdy
@Walo_1901	@ogdm
@WaykaPeru	@ogra
@Wayunkerra	@ogrx
@WestCOL_	@ogrs
@WikiGamez	@ogrf
@Wikirumanos1	@ogrh
@WilliamAlarcn12	@ogrk
@WilliamEspino19	@ogrw
@WilmerARamirezU	@ogru
@Wilothefirst	@ogre
@WilsonMerinoR	@ogrc
@Wilson_Suaza_	@ogrv
@Wimbledon	@ogrd
@Winchester1121	@ogrl
@Wladimyr15	@ogrt
@WomensHealthESP	@ogrj
@XSolidaria	@ogrz
@XaviRodriguez	@ogrp
@Xbox	@ogrq
@XboxP3	@ogri
@XboxStudio	@ogrb
@Xbox_Spain	@ogrn
@XemaGalo	@ogry
@XimeSalgadoR	@ogrm
@XoveBandaNaron	@ogla
@Yaari97369910	@oglx
@Yankar52	@ogls
@Ydalith41	@oglf
@Yemuyin	@oglh
@YihiRM	@oglk
@YoAlejoV	@oglw
@YoLibro	@oglu
@Yolanda_Diaz_	@ogle
@YolenBby	@oglc
@YoliSahhar	@oglv
@YorryWarthon	@ogld
@YouTube	@oglr
@YoungDragon69	@oglt
@Yuluga	@oglj
@Yunanueva	@oglz
@Yutuberjdgalo	@oglp
@ZRafinger	@oglq
@ZTercio	@ogli
@ZahiaGC	@oglb
@Zapatista72	@ogln
@Zekyyyyyyy	@ogly
@ZelenskyyUa	@oglm
@Zovatto55	@ogta
@Zulo_ESP2	@ogtx
@Zutano30	@ogts
@Zutoia19571	@ogtf
@_Alexbc1	@ogth
@_Ama_lur_	@ogtk
@_Benito___	@ogtw
@_CarlosAbreo	@ogtu
@_Edgar_ESP	@ogte
@_Gumball_5	@ogtc
@_Gus7RG	@ogtv
@_JorgeGuerra_	@ogtd
@_JuanEspadas	@ogtr
@_MrKyuusai_	@ogtl
@_PUYlFCB	@ogtj
@_Punhal_	@ogtz
@_REDInformativa	@ogtp
@_SantosTrinidad	@ogtq
@__Nasgul__	@ogti
@__huesitos	@ogtb
@__joliveira__	@ogtn
@_adrianrguez21	@ogty
@_bjorn10	@ogtm
@_danieltoro	@ogja
@_girot0_	@ogjx
@_iIIuminati_2	@ogjs
@_infolibre	@ogjf
@_javi_____	@ogjh
@_morapr	@ogjk
@_onerolita	@ogjw
@_rebelion_org	@ogju
@_ricards_	@ogje
@a1varo_lopez	@ogjc
@a320cat	@ogjv
@a_lastima	@ogjd
@aajimcas	@ogjr
@aarongreenberg	@ogjl
@aavvelpalo	@ogjt
@abajatelboxer	@ogjz
@abc_es	@ogjp
@abcdesevilla	@ogjq
@aberron	@ogji
@abran_susana	@ogjb
@abyss0one	@ogjn
@achperu	@ogjy
@achuchones	@ogjm
@acompanado_el	@ogza
@adria_bellet_P	@ogzx
@adrian_076	@ogzs
@adrianglez444	@ogzf
@adrianmateos	@ogzh
@adrianrmdiaz55	@ogzk
@adriansantanag	@ogzw
@adrimantres	@ogzu
@afidro_colombia	@ogze
@africa__2305	@ogzc
@agentesdequito	@ogzv
@agiraldoro	@ogzd
@aguspiza	@ogzr
@ahbuenosiquiera	@ogzl
@ahlisto	@ogzt
@aiammohamedd	@ogzj
@aiarakoa	@ogzp
@ainasoria05	@ogzq
@aj_rojasm	@ogzi
@akapilka	@ogzb
@al_batalyawsi	@ogzn
@alalae4	@ogzy
@alavamedicus	@ogzm
@albariikoke	@ogpa
@albertguivernau	@ogpx
@albertinyo10	@ogps
@alberto080451	@ogpf
@albertointernet	@ogph
@albertoowono	@ogpk
@alberuru97	@ogpw
@alcaldeledezma	@ogpu
@alcaldiaarauca	@ogpe
@alcorconcultura	@ogpc
@alejandro16999	@ogpv
@alejoZuluagaSi1	@ogpd
@alejo_sd__	@ogpr
@alejo_vi	@ogpl
@alejomontess	@ogpt
@alemorort	@ogpj
@alenietomarr	@ogpz
@alescu72	@ogpq
@alex_gallego3	@ogpi
@alexagomez2000	@ogpb
@alexaplomo79	@ogpn
@alexistocq	@ogpy
@alexolalla98	@ogpm
@alexsc_03	@ogqa
@alexxsardon	@ogqx
@alfredoduro1	@ogqs
@alfredorivas184	@ogqf
@alicanteayto	@ogqh
@aliciaapelegrin	@ogqk
@aliii017_	@ogqw
@almejjaa	@ogqu
@alonso_dm	@ogqe
@alpha_tm	@ogqc
@alphasniper1977	@ogqv
@alquilerdfm	@ogqd
@alsoldelacosta	@ogqr
@alvaro_orduna	@ogql
@alvaro_wasabi	@ogqt
@alvaroh1408	@ogqj
@amaraloficial	@ogqz
@amarina_turismo	@ogqp
@amaynar	@ogqi
@amcquito	@ogqb
@americatalunya	@ogqn
@amerifamsunited	@ogqy
@amiguitotuyo12	@ogqm
@aminazmani	@ogia
@amnistiaespana	@ogix
@amnistiamadrid	@ogis
@amoleiro	@ogif
@ampomata	@ogih
@amturiel	@ogik
@anaa_vallee	@ogiw
@anacaldee__	@ogiu
@anairamdemian	@ogie
@anaraffo1	@ogic
@anasuea	@ogiv
@andaluciaacoge	@ogid
@andermuruzabal	@ogir
@andreajp86	@ogil
@andreejmnz	@ogit
@andres_lpez93	@ogij
@andresacosta02	@ogiz
@andresbernanrdo	@ogip
@andresoc97	@ogiq
@andresxt9	@ogib
@anfiga_	@ogin
@angel34_jose	@ogiy
@angel_diaze	@ogim
@angel_novoa	@ogba
@angelamrobledo	@ogbx
@anitaragel5	@ogbs
@anne_camozzi	@ogbf
@anneildg	@ogbh
@ansantoyo	@ogbk
@antonigil44	@ogbw
@antonioRG9	@ogbu
@antoniocarriza3	@ogbe
@apeco_urosario	@ogbc
@apf1990	@ogbv
@aphonicabny	@ogbd
@aqua_gib	@ogbr
@aquelciudadano	@ogbl
@ar_juanma	@ogbt
@arabnews	@ogbj
@aragonvox	@ogbz
@ardesangres	@ogbp
@area_lorca	@ogbq
@ariasmartinez84	@ogbi
@ariava_	@ogbn
@arielstorres	@ogby
@aristizabaland	@ogbm
@armero00	@ogna
@armesillaconde	@ognx
@arronisraul	@ogns
@arthistoryblog	@ognf
@arturoCmusic	@ognh
@arturojb18	@ognk
@asaris04	@ognw
@aschapire	@ognu
@asdfghj1412	@ogne
@astianmi	@ognc
@astridtgtz	@ognv
@atchouameni	@ognd
@ateoyagnostico	@ognr
@atleticbalears	@ognl
@augusthorndike	@ognt
@auroraborreal	@ognj
@aviajarblog	@ognz
@awanakanaria	@ognp
@aytogr	@ognq
@ayudaenaccion	@ogni
@ayudamehenry	@ognb
@azemilano1	@ogny
@aznar_gloria	@ognm
@babadmerchan	@ogya
@backtolife_2023	@ogyx
@baddrevenge	@ogys
@badidibum	@ogyf
@bagner_garzon	@ogyh
@bajounapalmera	@ogyk
@bargueno_2	@ogyw
@baron_oberon	@ogyu
@batatasaomurro	@ogye
@baynanaes	@ogyc
@bbcmundo	@ogyv
@begonavillacis	@ogyd
@benda_bfree	@ogyr
@beron_ricardo	@ogyl
@bertamontanerfa	@ogyt
@bethesda_ESP	@ogyj
@bew66w	@ogyz
@bewatermyfrei	@ogyp
@beyourself7979	@ogyq
@bhadbcky	@ogyi
@bibiscookie	@ogyb
@bichosdecampo	@ogyn
@biodiversidadla	@ogym
@bipajenkins	@ogma
@bitxarraca	@ogmx
@blvcom	@ogms
@boell_MXCA	@ogmf
@bootyhypnotic	@ogmh
@borja_f_e	@ogmk
@bourbonni	@ogmw
@boye_g	@ogmu
@brian70_ve	@ogme
@brian_dlh	@ogmc
@bruja_oscura	@ogmv
@brujilson	@ogmd
@btxcgnbv	@ogmr
@buchhandler_fet	@ogml
@bufarracas69	@ogmt
@buhos_Brinzal	@ogmj
@buqueinsignia4	@ogmz
@burgosusana	@ogmp
@buscandoalfiz	@ogmq
@bvcColombia	@ogmi
@byremach	@ogmb
@c_tangana	@ogmn
@cachersociety	@ogmy
@cadenaser_avila	@ofax
@calamarooficial	@ofas
@camamuriesp	@ofag
@camilopolavieja	@ofah
@canchibuena	@ofak
@cannavaraujo	@ofaw
@capicchio	@ofau
@capitan7an7an	@ofae
@caporalfurrier	@ofac
@car81548938	@ofav
@carla65962203	@ofad
@carlaconwifi	@ofar
@carlesenric	@ofal
@carlito_gomez	@ofat
@carlitosdm66	@ofaj
@carlmat44	@ofaz
@carlos__alsina	@ofap
@carlosalulema	@ofaq
@carlosandrrrres	@ofai
@carloscaique77	@ofab
@carloscuestaEM	@ofan
@carlosdavidgf	@ofay
@carlosmascarlos	@ofam
@carlosmconde	@ofxa
@carlosmusicspot	@ofxs
@carlosreyg	@ofxg
@carlossmato	@ofxh
@carlosxbox1109	@ofxk
@carlotasalazar	@ofxw
@carlotasosa	@ofxu
@carmen12019425	@ofxe
@carmen_6691	@ofxc
@carmerocasegui	@ofxv
@caroherreros	@ofxd
@carrefnza_	@ofxr
@carreragonzalo	@ofxl
@casciari	@ofxt
@casifatima	@ofxj
@casihippie	@ofxz
@castilloangel79	@ofxp
@castro_luis	@ofxq
@casualrevoluti1	@ofxi
@catcasamance	@ofxb
@causit4rellena	@ofxn
@cav_carmen	@ofxy
@cayemo	@ofxm
@cdaponce	@ofsa
@cdbinefar	@ofsx
@cdcastellon	@ofsg
@ceciliaencina	@ofsh
@cejamorales	@ofsk
@centinelamet	@ofsw
@centre_IRIDIA	@ofsu
@ceroirreflexion	@ofse
@cesarastudillo	@ofsc
@cesardbecker	@ofsv
@cesikarsmith	@ofsd
@cfhercules	@ofsr
@chacalburiel	@ofsl
@chamas_zena	@ofst
@chamasenaccion	@ofsj
@chamo_199	@ofsz
@chamo_rulin	@ofsp
@chamtourimourad	@ofsq
@change_es	@ofsi
@chanofss	@ofsb
@charogonrod	@ofsn
@charovargas_	@ofsy
@chibisake	@ofsm
@childishdiey	@ofga
@chipi_wal	@ofgx
@chipiguevara14	@ofgs
@chipilaso93	@ofgh
@chonlago	@ofgk
@christian_garpe	@ofgw
@christioncillo	@ofgu
@chuchoindie	@ofge
@chuckiclampy	@ofgc
@cihar11	@ofgv
@cinturondorion_	@ofgd
@claralmst	@ofgr
@clarembaux	@ofgl
@claudiapalacios	@ofgt
@cmgorriaran	@ofgj
@cnegobec	@ofgz
@coe_es	@ofgp
@colomba_huacha	@ofgq
@compromis	@ofgi
@conecLectores	@ofgb
@confeniae1	@ofgn
@consejo_cpgdu	@ofgy
@constanzapaler1	@ofgm
@continta_mt	@ofha
@contrastado	@ofhx
@cordobahoyes	@ofhs
@cortesmarce	@ofhg
@cortsval	@ofhk
@cosasdelorca	@ofhw
@coucoumar	@ofhu
@coyiote01news	@ofhe
@cparedesr	@ofhc
@cperezm97	@ofhv
@cpt340	@ofhd
@creditoycaucion	@ofhr
@crihcrihcrih	@ofhl
@cristiancano624	@ofht
@cristianchiclan	@ofhj
@cristinadimo	@ofhz
@criszzuela	@ofhp
@criticonico	@ofhq
@cronicasdeckard	@ofhi
@crunchyroll_es	@ofhb
@ctxt_es	@ofhn
@cuadradillo21	@ofhy
@cuestiondmedios	@ofhm
@cuevas_dawson	@ofka
@cuquemar	@ofkx
@cuquita1982	@ofks
@cutecitoo	@ofkg
@cyanidesvn	@ofkh
@cyberdemonia	@ofkw
@d7anace	@ofku
@dabiz1313	@ofke
@daliarojas5	@ofkc
@damex_io	@ofkv
@damikorn2014	@ofkd
@dani_unicorn1	@ofkr
@daniduk345	@ofkl
@danielvimora	@ofkt
@danuca23	@ofkj
@dastansullivanf	@ofkz
@datoatipico	@ofkp
@dave73es	@ofkq
@david_h_morales	@ofki
@davidbalarezo	@ofkb
@davidbodas_	@ofkn
@davidpareja	@ofky
@davidvitores0	@ofkm
@dayuspessem	@ofwa
@dchxng	@ofwx
@de_gamin	@ofws
@de_pinga_chama	@ofwg
@deadspanita	@ofwh
@dealarentina	@ofwk
@dedreviil	@ofwu
@del_illes	@ofwe
@delakinkan_	@ofwc
@delatorreajenjo	@ofwv
@delfipetredp	@ofwd
@delmedioeditor	@ofwr
@democratadudoso	@ofwl
@dentropormuerto	@ofwt
@deportegob	@ofwj
@descifraguerra	@ofwz
@desdelamoncloa	@ofwp
@desdibuixat	@ofwq
@deths_	@ofwi
@diaazyj	@ofwb
@diamaov	@ofwn
@dianacursada	@ofwy
@dianamotavo	@ofwm
@dianreig	@ofua
@diarioas	@ofux
@diariodeavisos	@ofus
@diariolaopinion	@ofug
@diasasaigonados	@ofuh
@diduseemytweet	@ofuk
@diegoamorgado	@ofuw
@diegomelorib	@ofue
@diegomrtg	@ofuc
@diegovggsantafe	@ofuv
@digital_alerta	@ofud
@dimensionlatina	@ofur
@diomcoop	@oful
@directopaladar	@ofut
@direnzacol	@ofuj
@dlacalle	@ofuz
@dmeestasmatando	@ofup
@dnp	@ofuq
@domingo87627346	@ofui
@dontknowthenam3	@ofub
@dosapa15	@ofun
@dparramejia	@ofuy
@drakulVCF	@ofum
@dramaxgurl	@ofea
@dreamers2gether	@ofex
@drogler	@ofes
@dsalazar2317411	@ofeg
@dsantosfacher	@ofeh
@dsegoviaatienza	@ofek
@dsmolansky	@ofew
@dugiedu	@ofeu
@durga_145	@ofec
@dusvimarin	@ofev
@eACNUR	@ofed
@e_sportingclub	@ofer
@eaaa2022	@ofel
@earriar	@ofet
@ebcc1991	@ofej
@ecd_	@ofez
@ecidlm	@ofep
@eclementen	@ofeq
@eco_liberal	@ofei
@ecuacangye	@ofeb
@ecuainm_oficial	@ofen
@ed_peninsula	@ofey
@edgarcuenca19	@ofem
@edmapi	@ofca
@eduardodelp	@ofcx
@eduardoinda	@ofcs
@edyalviarez	@ofcg
@ejdecena	@ofch
@elEconomistaes	@ofck
@el_pais	@ofcw
@el_yisus_moro	@ofcu
@elalegrerobin	@ofce
@elbarroquista	@ofcv
@elcitizen	@ofcd
@elcolombiano	@ofcr
@elcomercio_peru	@ofcl
@elcomerciocom	@ofct
@elcomerciodigit	@ofcj
@elcomunistanet	@ofcz
@elcuboderubik2	@ofcp
@eldebate_com	@ofcq
@eldemocratard	@ofci
@elderechoalno	@ofcb
@eldiacordoba	@ofcn
@eldiario_Madrid	@ofcy
@eldiario_rojo	@ofcm
@eldiarioes	@ofva
@eldisidenteOK	@ofvx
@electo_mania	@ofvs
@eledelara	@ofvg
@elespanolcom	@ofvh
@elespectador	@ofvk
@elgamingchannel	@ofvw
@elhamaxx	@ofvu
@eliasbendodo	@ofve
@elindepcom	@ofvc
@elmundoes	@ofvd
@elmundounbalon	@ofvr
@elnacionalcat	@ofvl
@eloisagonzlopez	@ofvt
@elolivo2	@ofvj
@eloscarale	@ofvz
@elpais_america	@ofvp
@elpais_espana	@ofvq
@elpaisamericaco	@ofvi
@elpatrullero_	@ofvb
@elperiodico	@ofvn
@elreysexobelga	@ofvy
@elrincondesele	@ofvm
@elrond90	@ofda
@elsaltodiario	@ofdx
@eltiempo	@ofds
@eluniversocom	@ofdg
@elverdu9	@ofdh
@emefeuve	@ofdk
@emiiATH	@ofdw
@empeltada	@ofdu
@empleogob	@ofde
@empresaexterior	@ofdc
@endsequera	@ofdv
@enfermera1990	@ofdr
@enpafi	@ofdl
@enricm2	@ofdt
@ensgismau	@ofdj
@entre_botones	@ofdz
@enzoalejo13	@ofdp
@epinternacional	@ofdq
@epmedioambiente	@ofdi
@ernesto1006	@ofdb
@ernestocortes28	@ofdn
@esCesarVidal	@ofdy
@es_marcoslazaro	@ofdm
@escar_gm	@ofra
@esecardona	@ofrx
@esenciales_info	@ofrs
@eslamananadeFJL	@ofrg
@espana_denoche	@ofrh
@est_lm9	@ofrk
@estebanrestre	@ofrw
@est√°	@ofru
@eurodani87	@ofre
@europapress	@ofrc
@eutmmali1	@ofrv
@evalartk	@ofrd
@evamora_tve	@ofrl
@evapalva	@ofrt
@ewtanasia	@ofrj
@exoscopia	@ofrz
@expansioncom	@ofrp
@ezemismo2_0	@ofrq
@f_bardales	@ofri
@fabricatele	@ofrb
@facha_hours	@ofrn
@fahima_93	@ofry
@falbur	@ofrm
@fandeAlfonsoX	@ofla
@fatoudiagne1841	@oflx
@fbioromana	@ofls
@fc________	@oflg
@fdbedout	@oflh
@federacionvoleibol	@oflk
@fel_irredimible	@oflw
@felipeleon88	@oflu
@felishuco1975	@ofle
@fenris1234	@oflc
@ferage	@oflv
@fercardenete	@ofld
@ferdeles	@oflr
@ferland_mendy	@oflt
@fernan12vws	@oflj
@fernandoossa	@oflz
@ferxxo4	@oflp
@fifaworldcup_es	@oflq
@filosofotodoa1e	@ofli
@firulai4ever	@oflb
@fiscal_es	@ofln
@fitomendonca	@ofly
@fjcnavas	@oflm
@flamihup	@ofta
@florecicadabril	@oftx
@fmcarreno	@ofts
@fmolestinae	@oftg
@followdelargo	@ofth
@franco_zega	@oftk
@frandalfelverde	@oftw
@franh_valle	@oftu
@franxo45409610	@ofte
@fsingerf	@oftc
@fullmuntion	@oftv
@fumigador01	@oftd
@fundacionTef	@oftr
@furbyflav	@oftl
@futbolbasecant	@oftj
@g	@oftz
@gabriel_astier	@oftp
@gabrielboric	@oftq
@gabrielfemia1	@ofti
@gabrielpastor65	@oftb
@gabrielrufian	@oftn
@gaceta_es	@ofty
@gala197809	@oftm
@galdonE1	@ofja
@galicoso	@ofjx
@gallegomauricio	@ofjs
@gallifantes	@ofjg
@gancho213	@ofjh
@garbanzoloco	@ofjk
@gastonreyno	@ofjw
@gatetevoraz	@ofju
@gemmaggv	@ofje
@gener_usuga	@ofjc
@genidelbasket	@ofjv
@geo_economix	@ofjd
@geoestratego	@ofjr
@gerardromero	@ofjl
@germancrespo10	@ofjt
@ghitis	@ofjz
@ghostindigo	@ofjp
@gigigigigisel	@ofjq
@gilcarsoy	@ofji
@giraltpablo	@ofjb
@girlygaal	@ofjn
@gisbert_ruben	@ofjy
@giulianacaccia	@ofjm
@giz_colombia	@ofza
@gleijournalist	@ofzx
@glennadaboin	@ofzs
@gmaemejota	@ofzg
@goldparr	@ofzh
@golgran	@ofzk
@goomyzz	@ofzw
@gordos_cojones	@ofzu
@gorka6990	@ofze
@grodriguez53	@ofzc
@gruberleonardo	@ofzv
@gruizplaza	@ofzd
@gsole14	@ofzr
@guapoforastero8	@ofzl
@guardiacivil	@ofzt
@gui_cavalheri	@ofzj
@guillermofesser	@ofzp
@guillon2511	@ofzq
@guinea_sonia	@ofzi
@guirei24	@ofzb
@gumbaismo	@ofzn
@gusgomez1701	@ofzy
@gustavrangel	@ofzm
@h0m3r02	@ofpa
@habitante_	@ofpx
@hablemosjuegos	@ofps
@halalalex	@ofpg
@headredblack	@ofph
@heartlandintl_	@ofpk
@heitairoi	@ofpw
@heraldoes	@ofpu
@hermanntertsch	@ofpe
@herreropedro	@ofpc
@heyyitsadai	@ofpv
@hg3434343	@ofpd
@hheafuckusa	@ofpr
@highdarIing	@ofpl
@highjacked420	@ofpt
@hjaceituno	@ofpj
@hosteltur	@ofpz
@houriaalioua	@ofpq
@hpas_salud	@ofpi
@hqrecargado	@ofpb
@huero32374316	@ofpn
@hugocostagolf	@ofpy
@hugorduartej	@ofpm
@hurgamemoriaPE	@ofqa
@huugoph	@ofqx
@huyelobo	@ofqs
@hxchis	@ofqg
@iTzPauG	@ofqh
@iamaye99	@ofqk
@icam_es	@ofqw
@icarusfine639	@ofqu
@icomalava	@ofqe
@idehpucp	@ofqc
@idkb71	@ofqv
@iegap	@ofqd
@ierrejon	@ofqr
@iescolar	@ofql
@iesebschool	@ofqt
@iggyhots	@ofqj
@ignamarhh	@ofqz
@ignprigar	@ofqp
@ikthsoo	@ofqi
@il_lustre	@ofqb
@ilumiNATTInatt	@ofqn
@imartinrodrigo	@ofqy
@imdorasadd	@ofqm
@imjackyrivero	@ofia
@impekko	@ofix
@inOUI	@ofis
@independienteco	@ofig
@infayd	@ofih
@inferno24778	@ofik
@infobae	@ofiw
@informacion_es	@ofiu
@inigolp	@ofie
@interiorgob	@ofic
@inyustificado	@ofiv
@iocmedia	@ofid
@ionebelarra	@ofir
@iotrecords	@ofil
@irimiabarroso	@ofit
@isa_3003	@ofij
@isabelacarballo	@ofiz
@isabelcastrofer	@ofip
@isabeljuanedaga	@ofiq
@isaiasC84843603	@ofib
@isaxuIa	@ofin
@isteve77	@ofiy
@ituerahipster	@ofim
@iuandalucia	@ofba
@izcraft48	@ofbx
@izquierdadiario	@ofbs
@j_echarte	@ofbg
@jacobpetrus_tve	@ofbh
@jaestevezprado1	@ofbk
@jaguireal	@ofbw
@jaiimeeperezz_	@ofbu
@jaimeberenguer	@ofbe
@jaimesl76	@ofbc
@jal9000nacional	@ofbv
@janethinostroza	@ofbd
@janogarcia_	@ofbr
@jaumeclotet	@ofbl
@javi1903fa	@ofbt
@javierbauluz	@ofbj
@javierirastorza	@ofbz
@javigarser	@ofbp
@javilsantos	@ofbq
@javimartc	@ofbi
@javimen_f	@ofbn
@javimorales_alm	@ofby
@javisanabria95	@ofbm
@jbasalo1970	@ofna
@jbizarro	@ofnx
@jcarreraandrade	@ofns
@jccl30	@ofng
@jcpastrana	@ofnh
@jcuervorz	@ofnk
@jcyl	@ofnw
@jdavid4444	@ofnu
@jdjsjjsjaa	@ofne
@jdskajfaosdi	@ofnc
@jeanpierre0798	@ofnv
@jeanwyllys_real	@ofnd
@jedmartin2010	@ofnr
@jerafervas1	@ofnl
@jessicaalbiach	@ofnt
@jesuitajonathan	@ofnj
@jesusdelaosa	@ofnz
@jesuslopezgil01	@ofnp
@jfmoriche	@ofnq
@jguaido	@ofni
@jhlasa	@ofnb
@jidavaloss	@ofny
@jjaviervazquez	@ofnm
@jkeey4	@ofya
@jmalbares	@ofyx
@jmcampanales2	@ofys
@jmoya87	@ofyg
@jncrlsprzgrc	@ofyh
@joan76061284	@ofyk
@joanribo	@ofyw
@joaocotrim21	@ofyu
@jojorium	@ofye
@jomasport	@ofyc
@jonasnuts	@ofyv
@jonathanmartinz	@ofyd
@jonlasagaldos	@ofyr
@jordi80610828	@ofyl
@jordiedu	@ofyt
@jordievole	@ofyj
@jorgebc06	@ofyz
@jorgegsolis1	@ofyp
@jorgekosky	@ofyq
@jorgeuuss	@ofyi
@jorinasdack	@ofyb
@jose_acb	@ofyn
@joseasekas	@ofym
@josedarochabar1	@ofma
@josegarcia747	@ofmx
@joseluisescriva	@ofms
@joseman24180775	@ofmg
@josemanuel81191	@ofmh
@josephbri1	@ofmk
@josepileggi	@ofmw
@josevicenteriv	@ofmu
@jotabe1963	@ofme
@joxi1974	@ofmc
@jpgomez13	@ofmv
@jscauce	@ofmd
@jsjbird01	@ofmr
@juan_ggallardo	@ofml
@juan_silla6	@ofmt
@juanan77_93	@ofmj
@juanborrelli	@ofmz
@juanca_saenz	@ofmp
@juancaholguin	@ofmq
@juanchamo21	@ofmi
@juanda_sd	@ofmb
@juandia07842974	@ofmn
@juandiegobc	@ofmy
@juandiegodev	@ohax
@juanfeherreg	@ohas
@juanflores18	@ohag
@juanfranesco	@ohaf
@juanitaaroquee	@ohak
@juanitacatano	@ohaw
@juanjo_ramos	@ohau
@juanjtortosa	@ohae
@juank23_7	@ohac
@juanlagra	@ohav
@juanluis_rod	@ohad
@juanluisruizpsc	@ohar
@juanmi324	@ohal
@juanmnunez65	@ohat
@juanmorenochapa	@ohaj
@juanpeburgos	@ohaz
@juanrallo	@ohap
@juansuraci	@ohaq
@juantor929	@ohai
@jucilnacional	@ohab
@jucja18	@ohan
@jujijasjas	@ohay
@julianaoxenford	@oham
@julianxarias	@ohxa
@julibmoya	@ohxs
@julioh464	@ohxg
@julipalacioc	@ohxf
@juralde	@ohxk
@jymyboy1	@ohxw
@k_rol84	@ohxu
@kamatortuga	@ohxe
@kamchatka_es	@ohxc
@kapi_ripa	@ohxv
@karolBenaventeH	@ohxd
@kas_colombia	@ohxr
@katy_ugarte	@ohxl
@kciesemier	@ohxt
@keentzyy	@ohxj
@kemasdalomismo	@ohxz
@kevin_sv503	@ohxp
@kikorguez	@ohxq
@kogmiaou	@ohxi
@kors7919	@ohxb
@kryptpublicidad	@ohxn
@kuomintanista	@ohxy
@kvcamp1	@ohxm
@lacamaradelarte	@ohsa
@lacentralec	@ohsx
@lacnateatro	@ohsg
@lacourtuaneta	@ohsf
@lacuarta	@ohsk
@ladiaria	@ohsw
@lady_sackville	@ohsu
@ladytron26	@ohse
@laforjadeltitan	@ohsc
@laguana	@ohsv
@laguipikiyokian	@ohsd
@lahistoriaec	@ohsr
@lalalalia	@ohsl
@lalocadelhacha	@ohst
@lamarea_com	@ohsj
@lamilitar	@ohsz
@lamordaza_com	@ohsp
@lanitrocarga	@ohsq
@lanuevaespana	@ohsi
@laotraandalucia	@ohsb
@lapante28157019	@ohsn
@lapatriacom	@ohsy
@lapipolecuador	@ohsm
@lapoderiofem	@ohga
@larazon_es	@ohgx
@lareflexionviva	@ohgs
@larepublica_pe	@ohgf
@laresonancia	@ohgk
@lasillavacia	@ohgw
@lasmananaskiss	@ohgu
@latalega_getafe	@ohge
@lauraacorazon	@ohgc
@laurabogotana	@ohgv
@laurardgz_	@ohgd
@lavanguardia	@ohgr
@laverdad_es	@ohgl
@layonelgil	@ohgt
@laysgoulart999	@ohgj
@lazaro_1901	@ohgz
@le0n_africano	@ohgp
@leafarkook	@ohgq
@leoalvaradoofc	@ohgi
@leon_dgz_javier	@ohgb
@leonardvalencia	@ohgn
@leoocai11	@ohgy
@leoshimo1	@ohgm
@libanklif	@ohfa
@libertad3098	@ohfx
@libertaddigital	@ohfs
@libertadyvida1	@ohfg
@ligiabolivar	@ohfk
@liotcas	@ohfw
@litrosdalcohol	@ohfu
@liusivaya	@ohfe
@lizvdeg	@ohfc
@ljcisneros	@ohfv
@locoporperu	@ohfd
@lola_mamen	@ohfr
@lololennon11	@ohfl
@lopez10_ro	@ohft
@lopezdoriga	@ohfj
@lopezobrador_	@ohfz
@lorca_jon	@ohfp
@lore_cuba5	@ohfq
@lorecuacar	@ohfi
@los_secretos	@ohfb
@losdenam	@ohfn
@losientomarc	@ohfy
@loulancho	@ohfm
@lsfernandeza	@ohka
@lucas19omas	@ohkx
@lucascarnelli10	@ohks
@lucaslauriente	@ohkg
@luciaa_cp9	@ohkf
@lucidezoe	@ohkw
@luis_achury89	@ohku
@luis_irua	@ohke
@luisalejovega	@ohkc
@luisandrita	@ohkv
@luisantonio_r	@ohkd
@luisevivanco	@ohkr
@luisig_vazquez	@ohkl
@luispcarita	@ohkt
@lukamodric10	@ohkj
@lullielnas	@ohkz
@lunamonelle	@ohkp
@lunatiko63	@ohkq
@lunnaneggra	@ohki
@luuuciiiaaagc	@ohkb
@luvmernessj	@ohkn
@luzverdevg3	@ohky
@lxmxvxo	@ohkm
@m3r0g0s	@ohwa
@mJoe8505	@ohwx
@m_a_d_r_i	@ohws
@m_rdanger0071	@ohwg
@ma_blazquez	@ohwf
@macarenazo2022	@ohwk
@madrid_IAS	@ohwu
@madridblaugrana	@ohwe
@maduradascom	@ohwc
@maguiacademia	@ohwv
@maimouna11D	@ohwd
@malacitana81	@ohwr
@malaga_este	@ohwl
@malayerba	@ohwt
@maleser23	@ohwj
@maliptc	@ohwz
@manflorico	@ohwp
@manoantonio_2	@ohwq
@manolofallero	@ohwi
@mantincelcatala	@ohwb
@manuchao	@ohwn
@manukord	@ohwy
@manuroldansal	@ohwm
@manutordecarras	@ohua
@mar63105380	@ohux
@marbella_fc	@ohus
@marca	@ohug
@marca_vlc	@ohuf
@marcanosimon82	@ohuk
@marcelaholguin	@ohuw
@marcelamar07	@ohue
@marcferra9	@ohuc
@marck_marck99	@ohuv
@marcogdavila	@ohud
@marcomosquerar	@ohur
@marcus_bravus	@ohul
@maria__perez	@ohut
@maria_belen	@ohuj
@maria_espin_ds	@ohuz
@maria_patino	@ohup
@mariakrunia	@ohuq
@mariapaulamb_	@ohui
@mariatuitea	@ohub
@maricruz_zeta	@ohun
@mariemolia	@ohuy
@mariliendre_	@ohum
@marimerdh	@ohea
@marin_blazquez	@ohex
@marinagomeznoya	@ohes
@mario_hart	@oheg
@mario_jsg	@ohef
@marioodtt99	@ohek
@marisa002001	@ohew
@maritesotelo	@oheu
@marjoriechavezm	@ohec
@markk1008	@ohev
@marlon_santi	@ohed
@marooto_	@oher
@martammorenoo_	@ohel
@martbravoB	@ohet
@marthadiazc	@ohej
@martin_fagoaga	@ohez
@martindonato	@ohep
@martinezcats	@oheq
@martinvillada1	@ohei
@masleer	@oheb
@mastegistaria3	@ohen
@matecastano	@ohey
@mateo_bjs	@ohem
@maurinhobarcelo	@ohca
@mauro23ramirez	@ohcx
@mauroandinoe	@ohcs
@maurocardia27	@ohcg
@maxpradera	@ohcf
@mbados79	@ohck
@mbechandia	@ohcw
@mcalema	@ohcu
@mcalerom	@ohce
@mcfachafly	@ohcv
@mdomingoballes	@ohcd
@me_muerdo	@ohcr
@mecpablo	@ohcl
@medeciangato	@ohct
@melgamike	@ohcj
@memebene1	@ohcz
@memes_zamora	@ohcp
@mendez_rudy	@ohcq
@mercatflors	@ohci
@mergallego	@ohcb
@meritxell_batet	@ohcn
@mestel9	@ohcy
@metro_madrid	@ohcm
@mgarciafreundt	@ohva
@mgarridocierva	@ohvx
@mi_mo_to	@ohvs
@mia_lapo	@ohvg
@miaumiaumiaushh	@ohvf
@micosapiens	@ohvk
@miguel44qg	@ohvw
@miguel_politik	@ohvu
@miguela03747973	@ohve
@miguelarturo131	@ohvc
@miguelcarmonaes	@ohvd
@miguelcortesmu	@ohvr
@miguelsabat	@ohvl
@migusant	@ohvt
@miiichelle___	@ohvj
@mijamart88	@ohvz
@milarosa72	@ohvp
@mindefensa	@ohvq
@minombrenoteimp	@ohvi
@miriamdiez	@ohvb
@miriamnoguerasM	@ohvn
@miropopiceditor	@ohvy
@misabelsaraviam	@ohvm
@mitchellkun_	@ohda
@mitecogob	@ohdx
@mjmonteroc	@ohds
@mjtorresh	@ohdg
@mlalanda	@ohdf
@mmffcc1	@ohdk
@mmora22_mora	@ohdw
@mnavarrorincon	@ohdu
@mohagerehou	@ohde
@mohamedali_05	@ohdc
@moiragham	@ohdv
@molxloko	@ohdr
@momdeportes	@ohdl
@momiyos	@ohdt
@monasterioR	@ohdj
@monicaoltra	@ohdz
@monicasalazar13	@ohdp
@monovr46	@ohdq
@mor_pili	@ohdi
@morah_ruth	@ohdb
@mossos	@ohdn
@movim13nto	@ohdy
@mrjesusfigueroa	@ohdm
@msanz	@ohra
@msikusimakusi	@ohrx
@mtruzmanp	@ohrs
@mundial_Qatar22	@ohrg
@munecamarce	@ohrf
@muslimgirl	@ohrk
@nadia24barra7	@ohrw
@nail_in_shoe	@ohru
@najat_driouech	@ohre
@nampitze	@ohrc
@naranjo_p	@ohrv
@natajero6	@ohrd
@natcmm98	@ohrl
@nathsparkles	@ohrt
@natiibedoya	@ohrj
@naturalezacyl	@ohrz
@naty_alfonsa	@ohrp
@nauseabundo_hs	@ohrq
@navi_lgm	@ohri
@nazandoval	@ohrb
@ndplaura	@ohrn
@ndresRS	@ohry
@nebadom	@ohrm
@neblaruz	@ohla
@neorreacionario	@ohlx
@neovenezuela	@ohls
@nesper4254	@ohlg
@ngelitobravo1	@ohlf
@nikamonina	@ohlk
@nitazeneta	@ohlw
@njra2	@ohlu
@nochecica	@ohle
@nocontextSebs	@ohlc
@nocontextfooty	@ohlv
@nodo50	@ohld
@noe80086	@ohlr
@noeibarruri	@ohlt
@noemacias1005	@ohlj
@noestoymalite	@ohlz
@noevs1	@ohlp
@nonaurosedcord	@ohlq
@nosoyalienada	@ohli
@nosoymafranpe	@ohlb
@nostalgianosnos	@ohln
@notgip	@ohly
@noticiAmerica	@ohlm
@noticias_tvperu	@ohta
@noticubahoy	@ohtx
@novia713	@ohts
@novoa_vane	@ohtg
@nuevatribuna	@ohtf
@numbereightball	@ohtk
@numer344	@ohtw
@nuno_fgs	@ohtu
@nunoe0e0	@ohte
@nurlov	@ohtc
@nurygglez	@ohtv
@oalfonsogarcia	@ohtd
@objetoarte	@ohtr
@oburneo40	@ohtl
@ocasiven	@ohtj
@ochoabravo32	@ohtz
@odonelorza2011	@ohtp
@oefb1904	@ohtq
@ofender_con	@ohti
@oierfano	@ohtb
@ojosambar	@ohtn
@okdiario	@ohty
@olga_vng	@ohtm
@olimpia_epiro	@ohja
@olympeabogados	@ohjx
@ondamadrid	@ohjs
@onuhabitat	@ohjg
@oostituu	@ohjf
@opinologonadie	@ohjk
@orelladeporco	@ohjw
@orriolsderipoll	@ohju
@orue_s	@ohje
@oscar_mora_	@ohjc
@oscar_puente_	@ohjv
@oscarabp	@ohjd
@oscarmurillom	@ohjr
@osoriosantiago	@ohjl
@otraparte	@ohjt
@overflow_error	@ohjz
@ozzieo212	@ohjp
@pMeteko	@ohjq
@pabloalonso_vcf	@ohji
@pablobpcoach	@ohjb
@pablocillo	@ohjn
@pablom_m	@ohjy
@pacobueso	@ohjm
@pacofloresc	@ohza
@pacolonyo_B	@ohzx
@pako_velezmlg	@ohzs
@panadero2196	@ohzg
@panagulias	@ohzf
@panchojimenezs	@ohzk
@paniz_moradi	@ohzw
@pantojaguille	@ohzu
@pao_guajira	@ohze
@paratuister	@ohzc
@parbolo	@ohzv
@parlacan	@ohzd
@parri59	@ohzr
@pasadetodotio	@ohzl
@pasatie61475832	@ohzt
@pasthightime	@ohzj
@patergongora	@ohzp
@patettico	@ohzq
@patmartinezc	@ohzi
@patry_af	@ohzb
@pattrosia	@ohzn
@patxilopez	@ohzy
@pau_llaves	@ohzm
@paucazorla	@ohpa
@paulaasaravia_	@ohpx
@paulaolitee	@ohps
@paulassanchezz_	@ohpg
@paulausternet	@ohpf
@paulitagarciag	@ohpk
@pazgabela	@ohpw
@pcmperu	@ohpu
@pecpablo	@ohpe
@pedro21755934	@ohpc
@pedroefese3	@ohpv
@pedroolucass__	@ohpd
@pehota_morskaya	@ohpr
@pelpalustre	@ohpl
@pensamientcrit	@ohpt
@pepetrequeRM	@ohpj
@pepeworld23	@ohpz
@pequena_roca	@ohpq
@pequeoastronau1	@ohpi
@perezreverte	@ohpb
@personeriabta	@ohpn
@petitniang94	@ohpy
@petrogustavo	@ohpm
@pgonzalezpar	@ohqa
@pia_dmn	@ohqx
@piacostar	@ohqs
@piedadcordoba	@ohqg
@pikaramagazine	@ohqf
@pintor_rojo	@ohqk
@pirocarasu	@ohqw
@pittiivor	@ohqu
@planetagonzo	@ohqe
@plbandido	@ohqc
@plumiferosoutOC	@ohqv
@poIiacriIamide	@ohqd
@pochoharbEC	@ohqr
@pocopan	@ohql
@podercomunista	@ohqt
@poisonganger	@ohqj
@policia	@ohqz
@policiademadrid	@ohqp
@policialocalvlc	@ohqi
@populares	@ohqb
@porCausaorg	@ohqn
@porquemenon	@ohqy
@portokalos21	@ohqm
@posso_sports	@ohia
@postretariana	@ohix
@pp_latina	@ohis
@ppandaluz	@ohig
@pscvilanova	@ohif
@psecada	@ohik
@psfcwb	@ohiw
@psisuki	@ohiu
@psoe	@ohie
@psoeandalucia	@ohic
@psoedeandalucia	@ohiv
@publico_es	@ohid
@publio74	@ohir
@puntomedio87	@ohil
@putomanuu	@ohit
@pvallin	@ohij
@q_chacal	@ohiz
@que	@ohip
@quico_ro	@ohiq
@quinzel_27	@ohib
@quiquepeinado	@ohin
@quotidiancook	@ohiy
@r60er6	@ohim
@radio3_rne	@ohba
@radio_pichincha	@ohbx
@radiolacalle	@ohbs
@rafaeldelolmo	@ohbg
@rafaelgz	@ohbf
@ramiroaguilart	@ohbk
@ramonarcusa	@ohbw
@raphhill	@ohbu
@raptor_dev0101	@ohbe
@ratasconplaca	@ohbc
@raulbrachi98	@ohbv
@raulrazondeson	@ohbd
@raulrivas05_1	@ohbr
@ravila67	@ohbl
@rbarbaranr	@ohbt
@rcnmundo	@ohbj
@realmadrid	@ohbz
@redclamor	@ohbp
@redhistoria	@ohbq
@redindomitable	@ohbi
@relevo	@ohbn
@relicheandres	@ohby
@rescueorg	@ohbm
@resugirmix	@ohna
@reunificacion_	@ohnx
@revista5W	@ohns
@revistadehistoria	@ohng
@reyitac	@ohnf
@reyruizsalsa	@ohnk
@ricardohashtag	@ohnw
@ricardomoontero	@ohnu
@ricardomv99	@ohne
@ricarospina	@ohnc
@rickymerino	@ohnv
@rimbaudarth	@ohnd
@rinnee_me	@ohnr
@rl7624	@ohnl
@rlopezaliaga1	@ohnt
@rmo14748	@ohnj
@robertilustrado	@ohnz
@roberto505032	@ohnp
@rogeliomtz75	@ohnq
@rojuuaka	@ohni
@romanosssrgo	@ohnb
@ronalfrodriguez	@ohny
@rosadiezglez	@ohnm
@rosalia	@ohya
@rosangelamorosp	@ohyx
@rosmudeneitor	@ohys
@rossy_bq	@ohyg
@rostamiccoli	@ohyf
@rougehead	@ohyk
@roxanaerazo11	@ohyw
@rpadpre	@ohyu
@rrazo	@ohye
@rtve	@ohyc
@rubenlodi	@ohyv
@rubensfranco	@ohyd
@rubio_escolano	@ohyr
@rubnpulido	@ohyl
@ryancastrro	@ohyt
@ryvillavicencio	@ohyj
@s	@ohyz
@s_sevilleja	@ohyp
@saez_VCF	@ohyq
@saghonduras	@ohyi
@saharalibrealba	@ohyb
@saidjaherrera	@ohyn
@saimards	@ohym
@saintmayo1981	@ohma
@salemv__	@ohmx
@salkisue_	@ohms
@salmanticae_	@ohmg
@saltladinastia	@ohmf
@salvaaguado	@ohmk
@salvameoficial	@ohmw
@sanchezcastejon	@ohmu
@sandraenriques9	@ohme
@sandrajara_	@ohmc
@santicalvicidad	@ohmv
@santiguarderas	@ohmd
@santiovalle	@ohmr
@santsfree	@ohml
@saralidiaester	@ohmt
@schuss13	@ohmj
@scudettocalcio2	@ohmz
@seguridad1849	@ohmp
@selfemvoleibol	@ohmq
@selshelbyville	@ohmi
@seluportela	@ohmb
@semarco	@ohmn
@sendaabaetxo	@ohmy
@senorrelampago	@okax
@sergioalcar_	@okas
@sergiorvil	@okag
@seveup_	@okaf
@sevillajordi	@okah
@sglezzzz	@okaw
@shirtarazona	@okau
@sibilafc	@okae
@sidalomismo	@okac
@sig_caceres	@okav
@sigridbazan	@okad
@silviavinan_arq	@okar
@simon_mupe	@okal
@simoninmadrid	@okat
@sincomplejos__	@okaj
@sindmanterosM	@okaz
@sinpermisoinfo	@okap
@sirarepolles	@okaq
@skereunpesado	@okai
@slbcarlitos	@okab
@slinkybass	@okan
@slozano888	@okay
@smilelissi	@okam
@socialholico	@okxa
@sofisanchezu	@okxs
@sopaduvas	@okxg
@soyhender	@okxf
@spain	@okxh
@splashjavier	@okxw
@sport	@okxu
@sportingafrica	@okxe
@spxx__	@okxc
@srzjwalters	@okxv
@steffa1990	@okxd
@stevek_wonders	@okxr
@stevenarce	@okxl
@subcantante	@okxt
@sulfatodecalci0	@okxj
@surdelorinoco	@okxz
@suso_ArtHistory	@okxp
@svazquezgomariz	@okxq
@sybelmartinez	@okxi
@taleuco	@okxb
@tallowlblue	@okxn
@tarabeisbol23	@okxy
@tatinmg23	@okxm
@tchouamenizao	@oksa
@tecno_boy	@oksx
@tecnoloxia	@oksg
@telanegra	@oksf
@teleSURtv	@oksh
@teleamazonasec	@oksw
@telecincoes	@oksu
@ternero_paco	@okse
@tevengoajoder1	@oksc
@tgirotti	@oksv
@thatkirbypic	@oksd
@the_ins_ru	@oksr
@therifu	@oksl
@therigor	@okst
@thetacticalt34	@oksj
@thome_RSG	@oksz
@tiempobrasero	@oksp
@tipicomoderno	@oksq
@tipoduro2	@oksi
@tiquetaki	@oksb
@tiraora	@oksn
@titaeti	@oksy
@titowankalaw	@oksm
@tjuanmarti	@okga
@todocoleccion	@okgx
@todoesmentiratv	@okgs
@todos_putoos	@okgf
@toledo_por	@okgh
@tomascasascm	@okgw
@tomeandres	@okgu
@tonigarias	@okge
@tonopp3049	@okgc
@tonyrabina	@okgv
@tradicionfp	@okgd
@trasmilenio	@okgr
@trastamara_ana	@okgl
@tribonian03	@okgt
@trixechita	@okgj
@tropicalpapi1	@okgz
@tttrinix	@okgp
@tulioisac1	@okgq
@twighard	@okgi
@txellblanxer	@okgb
@txemita	@okgn
@tyrannosapiens	@okgy
@uasbecuador	@okgm
@udeaalgeciras	@okfa
@ugluis	@okfx
@uhCaribe	@okfs
@uksergio	@okfg
@unabomber30	@okfh
@unalcoyano	@okfw
@unaynosvamospodcast	@okfu
@unchinodechina	@okfe
@unculemadrid	@okfc
@undivaga	@okfv
@unrwaes	@okfd
@unzu98	@okfr
@updayESP	@okfl
@urbimaria37	@okft
@uriaschrist	@okfj
@uverre94	@okfz
@v1t0t3	@okfp
@valenciaplaza	@okfq
@vanaudy	@okfi
@vanedelatorre	@okfb
@vatsimSpain	@okfn
@veintimillapier	@okfy
@velezpsoe	@okfm
@veneactivaorg	@okha
@venezolanats	@okhx
@venezolanoenpie	@okhs
@venprendedoras	@okhg
@veropolox	@okhf
@viajepatrimonio	@okhw
@vianabanjo	@okhu
@vicen112	@okhe
@vicenteopi	@okhc
@vicentsaeztauri	@okhv
@victorabadf1	@okhd
@victorcv777	@okhr
@victorjajoy	@okhl
@viejodelbujero	@okht
@vigobulldog	@okhj
@viksang	@okhz
@villarre201076	@okhp
@violafomina7	@okhq
@violetarnb	@okhi
@vir_sr	@okhb
@vitacora_	@okhn
@vitoquiles	@okhy
@vivelatino	@okhm
@vivianavizufe	@okwa
@vizcaone	@okwx
@vladimirpadrino	@okws
@vladiskld	@okwg
@vlc_JI	@okwf
@voluptama	@okwh
@vox_es	@okwu
@voxceuti	@okwe
@voz_populi	@okwc
@vxerocomunista	@okwv
@w3zd	@okwd
@wallstwolverine	@okwr
@walterobregon_	@okwl
@wariarepano1	@okwt
@wayvifnt	@okwj
@webEncestando	@okwz
@wharizinn	@okwp
@widaviye	@okwq
@wildestscream	@okwi
@wildevale	@okwb
@willaxtv	@okwn
@william_murillo	@okwy
@wilsonariasc	@okwm
@winoforever11	@okua
@wladimirferrer7	@okux
@wmansilla	@okus
@x1saharalibre	@okug
@xanamoran	@okuf
@xavieraldekoa	@okuh
@xitsnani	@okuw
@xriusenoticies	@okue
@ya_no_soy	@okuc
@yagoalons	@okuv
@yamil_xX	@okud
@yaretvirreyra	@okur
@yaruabella	@okul
@yct94938166	@okut
@ydvoq	@okuj
@yedra_conde	@okuz
@yoligrilla	@okup
@yosoynesh	@okuq
@yosoytuto	@okui
@yotele	@okub
@yukilyd	@okun
@yvangil	@okuy
@zacharinl	@okum
@zaidacastillo51	@okea
@zeepiii_	@okex
@zobrezorpreza	@okes
@zooliberalismo	@okeg
@zoraidamendez	@okef
@zubiagaynorzaga	@okeh
@zumbado_dla	@okew
